siraaj (Administrator)
nobody
accountsservice : query and manipulate user account information
acl : access control list - utilities
adduser : add and remove users and groups
adwaita-icon-theme : default icon theme of GNOME
aisleriot : GNOME solitaire card game collection
alsa-topology-conf : ALSA topology configuration files
alsa-ucm-conf : ALSA Use Case Manager configuration files
alsa-utils : Utilities for configuring and using ALSA
anacron : cron-like program that doesn't go by time
analog : web server log analyzer
apache2 : Apache HTTP Server
apache2-bin : Apache HTTP Server (modules and other binary files)
apache2-data : Apache HTTP Server (common files)
apache2-doc : Apache HTTP Server (on-site documentation)
apache2-utils : Apache HTTP Server (utility programs for web servers)
apg : Automated Password Generator - Standalone version
apparmor : user-space parser utility for AppArmor
appstream : Software component metadata management
apt : commandline package manager
apt-config-icons : APT configuration snippet to enable icon downloads
apt-listchanges : package change history notification tool
apt-utils : package management related utility programs
aspell : GNU Aspell spell-checker
aspell-en : English dictionary for GNU Aspell
at-spi2-common : Assistive Technology Service Provider Interface (common files)
at-spi2-core : Assistive Technology Service Provider Interface (D-Bus core)
avahi-daemon : Avahi mDNS/DNS-SD daemon
baobab : GNOME disk usage analyzer
base-files : Debian base system miscellaneous files
base-passwd : Debian base system master password and group files
bash : GNU Bourne Again SHell
bash-completion : programmable completion for the bash shell
bc : GNU bc arbitrary precision calculator language
bind9-dnsutils : Clients provided with BIND 9
bind9-host : DNS Lookup Utility
bind9-libs:amd64 : Shared Libraries used by BIND 9
bluez : Bluetooth tools and daemons
bluez-obexd : bluez obex daemon
bogofilter : fast Bayesian spam filter (meta package)
bogofilter-bdb : fast Bayesian spam filter (Berkeley DB)
bogofilter-common : fast Bayesian spam filter (common files)
bolt : system daemon to manage thunderbolt 3 devices
brasero-common : Common files for the Brasero CD burning application and library
bsdextrautils : extra utilities from 4.4BSD-Lite
bsdutils : basic utilities from 4.4BSD-Lite
bubblewrap : utility for unprivileged chroot and namespace manipulation
busybox : Tiny utilities for small and embedded systems
bzip2 : high-quality block-sorting file compressor - utilities
ca-certificates : Common CA certificates
ca-certificates-java : Common CA certificates (JKS keystore)
cdrdao : records CDs in Disk-At-Once (DAO) mode
cheese : tool to take pictures and videos from your webcam
cheese-common : Common files for the Cheese tool to take pictures and videos
chrome-gnome-shell : GNOME Shell integration for browsers - transitional package
coinor-libcbc3:amd64 : Coin-or branch-and-cut mixed integer programming solver (shared libraries)
coinor-libcgl1:amd64 : COIN-OR Cut Generation Library
coinor-libclp1:amd64 : Coin-or linear programming solver (shared libraries)
coinor-libcoinmp1v5:amd64 : Simple C API for COIN-OR Solvers Clp and Cbc -- library
coinor-libcoinutils3v5:amd64 : Coin-or collection of utility classes (binaries and libraries)
coinor-libosi1v5:amd64 : COIN-OR Open Solver Interface
colord : system service to manage device colour profiles -- system daemon
colord-data : system service to manage device colour profiles -- data files
console-setup : console font and keymap setup program
console-setup-linux : Linux specific part of console-setup
coreutils : GNU core utilities
cpio : GNU cpio -- a program to manage archives of files
cpp : GNU C preprocessor (cpp)
cpp-12 : GNU C preprocessor
cracklib-runtime : runtime support for password checker library cracklib2
cron : process scheduling daemon
cron-daemon-common : process scheduling daemon's configuration files
cups : Common UNIX Printing System(tm) - PPD/driver support, web interface
cups-browsed : OpenPrinting CUPS Filters - cups-browsed
cups-client : Common UNIX Printing System(tm) - client programs (SysV)
cups-common : Common UNIX Printing System(tm) - common files
cups-core-drivers : Common UNIX Printing System(tm) - driverless printing
cups-daemon : Common UNIX Printing System(tm) - daemon
cups-filters : OpenPrinting CUPS Filters - Main Package
cups-filters-core-drivers : OpenPrinting CUPS Filters - Driverless printing
cups-ipp-utils : Common UNIX Printing System(tm) - IPP developer/admin utilities
cups-pk-helper : PolicyKit helper to configure cups with fine-grained privileges
cups-ppdc : Common UNIX Printing System(tm) - PPD manipulation utilities
cups-server-common : Common UNIX Printing System(tm) - server common files
curl : command line tool for transferring data with URL syntax
dash : POSIX-compliant shell
dbus : simple interprocess messaging system (system message bus)
dbus-bin : simple interprocess messaging system (command line utilities)
dbus-daemon : simple interprocess messaging system (reference message bus)
dbus-session-bus-common : simple interprocess messaging system (session bus configuration)
dbus-system-bus-common : simple interprocess messaging system (system bus configuration)
dbus-user-session : simple interprocess messaging system (systemd --user integration)
dconf-cli : simple configuration storage system - utilities
dconf-gsettings-backend:amd64 : simple configuration storage system - GSettings back-end
dconf-service : simple configuration storage system - D-Bus service
debconf : Debian configuration management system
debconf-i18n : full internationalization support for debconf
debian-archive-keyring : GnuPG archive keys of the Debian archive
debian-faq : Debian Frequently Asked Questions
debianutils : Miscellaneous utilities specific to Debian
default-jre : Standard Java or Java compatible Runtime
default-jre-headless : Standard Java or Java compatible Runtime (headless)
desktop-base : common files for the Debian Desktop
desktop-file-utils : Utilities for .desktop files
dictionaries-common : spelling dictionaries - common utilities
diffutils : File comparison utilities
dirmngr : GNU privacy guard - network certificate management service
discover : hardware identification system
discover-data : Data lists for Discover hardware detection system
distro-info-data : information about the distributions' releases (data files)
dmidecode : SMBIOS/DMI table decoder
dmsetup : Linux Kernel Device Mapper userspace library
dns-root-data : DNS root hints and DNSSEC trust anchor
dnsmasq-base : Small caching DNS proxy and DHCP/TFTP server
doc-debian : Debian Project documentation and other documents
docbook-xml : standard XML documentation system for software and systems
dosfstools : utilities for making and checking MS-DOS FAT filesystems
dpkg : Debian package management system
e2fsprogs : ext2/ext3/ext4 file system utilities
eject : ejects CDs and operates CD-Changers under Linux
emacsen-common : Common facilities for all emacsen
enchant-2 : Wrapper for various spell checker engines (binary programs)
eog : Eye of GNOME graphics viewer program
espeak-ng-data:amd64 : Multi-lingual software speech synthesizer: speech data files
ethtool : display or change Ethernet device settings
evince : Document (PostScript, PDF) viewer
evince-common : Document (PostScript, PDF) viewer - common files
evolution : groupware suite with mail client and organizer
evolution-common : architecture independent files for Evolution
evolution-data-server : evolution database backend server
evolution-data-server-common : architecture independent files for Evolution Data Server
evolution-plugin-bogofilter : standard plugins for Evolution (bogofilter)
evolution-plugin-pstimport : standard plugins for Evolution (pstimport)
evolution-plugins : standard plugins for Evolution
exfatprogs : exFAT file system utilities
fdisk : collection of partitioning utilities
file : Recognize the type of data in a file using "magic" numbers
file-roller : archive manager for GNOME
findutils : utilities for finding files--find, xargs
firefox-esr : Mozilla Firefox web browser - Extended Support Release (ESR)
firmware-linux-free : Binary firmware for various drivers in the Linux kernel
five-or-more : make color lines of five or more length
folks-common : library to aggregates people into metacontacts (common files)
fontconfig : generic font configuration library - support binaries
fontconfig-config : generic font configuration library - configuration
fonts-cantarell : sans serif font family designed for on-screen readability
fonts-dejavu : metapackage to pull in fonts-dejavu-core and fonts-dejavu-extra
fonts-dejavu-core : Vera font family derivate with additional characters
fonts-dejavu-extra : Vera font family derivate with additional characters (extra variants)
fonts-droid-fallback : handheld device font with extensive style and language support (fallback)
fonts-lato : sans-serif typeface family font
fonts-liberation : Fonts with the same metrics as Times, Arial and Courier
fonts-liberation2 : Fonts with the same metrics as Times, Arial and Courier (v2)
fonts-noto-color-emoji : color emoji font from Google
fonts-noto-mono : "No Tofu" monospaced font family with large Unicode coverage
fonts-opensymbol : OpenSymbol TrueType font
fonts-quicksand : sans-serif font with round attributes
fonts-symbola : symbolic font providing emoji characters from Unicode 9.0
fonts-urw-base35 : font set metric-compatible with the 35 PostScript Level 2 Base Fonts
four-in-a-row : Four in a Row game for GNOME
fuse3 : Filesystem in Userspace (3.x version)
fwupd : Firmware update daemon
fwupd-amd64-signed : Tools to manage UEFI firmware updates (signed)
gcc-12-base:amd64 : GCC, the GNU Compiler Collection (base package)
gcc-12-base:i386 : GCC, the GNU Compiler Collection (base package)
gcr : GNOME crypto services (daemon and tools)
gdisk : GPT fdisk text-mode partitioning tool
gdm3 : GNOME Display Manager
geoclue-2.0 : geoinformation service
geocode-glib-common : icons for the geocode-glib library
gettext-base : GNU Internationalization utilities for the base system
ghostscript : interpreter for the PostScript language and for PDF
gir1.2-accountsservice-1.0:amd64 : GObject introspection data for AccountService
gir1.2-adw-1:amd64 : GObject introspection files for libadwaita
gir1.2-atk-1.0:amd64 : ATK accessibility toolkit (GObject introspection)
gir1.2-atspi-2.0:amd64 : Assistive Technology Service Provider (GObject introspection)
gir1.2-clutter-1.0:amd64 : GObject introspection data for the Clutter 1.0 library
gir1.2-cogl-1.0:amd64 : GObject introspection data for the Cogl 1.0 library
gir1.2-coglpango-1.0:amd64 : GObject introspection data for the CoglPango 1.0 library
gir1.2-evince-3.0:amd64 : GObject introspection data for the evince libraries
gir1.2-freedesktop:amd64 : Introspection data for some FreeDesktop components
gir1.2-gck-1:amd64 : GObject introspection data for the GCK library
gir1.2-gcr-3:amd64 : GObject introspection data for the GCR library
gir1.2-gdesktopenums-3.0:amd64 : GObject introspection for GSettings desktop-wide schemas
gir1.2-gdkpixbuf-2.0:amd64 : GDK Pixbuf library - GObject-Introspection
gir1.2-gdm-1.0 : GObject introspection data for the GNOME Display Manager
gir1.2-geoclue-2.0:amd64 : convenience library to interact with geoinformation service (introspection)
gir1.2-geocodeglib-2.0:amd64 : introspection data for geocode-glib library
gir1.2-glib-2.0:amd64 : Introspection data for GLib, GObject, Gio and GModule
gir1.2-gmenu-3.0:amd64 : GObject introspection data for the GNOME menu library
gir1.2-gnomebluetooth-3.0:amd64 : Introspection data for GnomeBluetooth
gir1.2-gnomedesktop-3.0:amd64 : Introspection data for GnomeDesktop (GTK 3)
gir1.2-gnomedesktop-4.0:amd64 : Introspection data for GnomeDesktop (GTK 4)
gir1.2-goa-1.0:amd64 : Introspection data for GNOME Online Accounts
gir1.2-graphene-1.0:amd64 : library of graphic data types (introspection files)
gir1.2-grilo-0.3:amd64 : Framework for discovering and browsing media - GObject introspection data
gir1.2-gst-plugins-bad-1.0:amd64 : GObject introspection data for the GStreamer libraries from the "bad" set
gir1.2-gst-plugins-base-1.0:amd64 : GObject introspection data for the GStreamer Plugins Base library
gir1.2-gstreamer-1.0:amd64 : GObject introspection data for the GStreamer library
gir1.2-gtk-3.0:amd64 : GTK graphical user interface library -- gir bindings
gir1.2-gtk-4.0:amd64 : GTK graphical user interface library -- gir bindings
gir1.2-gtkclutter-1.0:amd64 : GObject introspection data for the GTK+ Clutter library
gir1.2-gtksource-4:amd64 : gir files for the GTK+ syntax highlighting widget
gir1.2-gweather-4.0:amd64 : GObject introspection data for the GWeather library
gir1.2-handy-1:amd64 : GObject introspection files for libhandy
gir1.2-harfbuzz-0.0:amd64 : OpenType text shaping engine (GObject introspection data)
gir1.2-ibus-1.0:amd64 : Intelligent Input Bus - introspection data
gir1.2-javascriptcoregtk-4.0:amd64 : JavaScript engine library from WebKitGTK - GObject introspection data
gir1.2-javascriptcoregtk-4.1:amd64 : JavaScript engine library from WebKitGTK - GObject introspection data
gir1.2-json-1.0:amd64 : GLib JSON manipulation library (introspection data)
gir1.2-malcontent-0:amd64 : GObject introspection bindings for libmalcontent
gir1.2-mediaart-2.0:amd64 : GObject introspection data for MediaArt library
gir1.2-mutter-11:amd64 : GObject introspection data for Mutter
gir1.2-nm-1.0:amd64 : GObject introspection data for the libnm library
gir1.2-nma-1.0:amd64 : GObject introspection data for libnma
gir1.2-notify-0.7:amd64 : sends desktop notifications to a notification daemon (Introspection files)
gir1.2-packagekitglib-1.0 : GObject introspection data for the PackageKit GLib library
gir1.2-pango-1.0:amd64 : Layout and rendering of internationalized text - gir bindings
gir1.2-peas-1.0:amd64 : Application plugin library (introspection files)
gir1.2-polkit-1.0 : GObject introspection data for polkit
gir1.2-rb-3.0:amd64 : GObject introspection data for the rhythmbox music player
gir1.2-rest-1.0:amd64 : REST service access library (introspection files)
gir1.2-rsvg-2.0:amd64 : gir files for renderer library for SVG files
gir1.2-secret-1:amd64 : Secret store (GObject-Introspection)
gir1.2-shumate-1.0:amd64 : GTK4 widgets for embedded maps - gir bindings
gir1.2-soup-2.4:amd64 : GObject introspection data for the libsoup HTTP library
gir1.2-soup-3.0:amd64 : GObject introspection data for the libsoup HTTP library
gir1.2-totem-1.0:amd64 : GObject introspection data for Totem media player
gir1.2-totemplparser-1.0:amd64 : GObject introspection data for the Totem Playlist Parser library
gir1.2-tracker-3.0:amd64 : GObject introspection data for Tracker
gir1.2-upowerglib-1.0:amd64 : GObject introspection data for upower
gir1.2-webkit2-4.0:amd64 : Web content engine library for GTK - GObject introspection data
gir1.2-webkit2-4.1:amd64 : Web content engine library for GTK - GObject introspection data
gir1.2-wnck-3.0:amd64 : GObject introspection data for the WNCK library
git : fast, scalable, distributed revision control system
git-man : fast, scalable, distributed revision control system (manual pages)
gjs : Mozilla-based javascript bindings for the GNOME platform (cli tool)
gkbd-capplet : GNOME control center tools for libgnomekbd
glib-networking:amd64 : network-related giomodules for GLib
glib-networking-common : network-related giomodules for GLib - data files
glib-networking-services : network-related giomodules for GLib - D-Bus services
gnome : Full GNOME Desktop Environment, with extra components
gnome-2048 : sliding tile puzzle game
gnome-accessibility-themes : High Contrast GTK 2 theme and icons
gnome-backgrounds : Set of backgrounds packaged with the GNOME desktop
gnome-bluetooth-3-common : GNOME Bluetooth 3 common files
gnome-bluetooth-sendto : GNOME Bluetooth Send To app
gnome-browser-connector : GNOME Shell extensions integration for web browsers
gnome-calculator : GNOME desktop calculator
gnome-calendar : Calendar application for GNOME
gnome-characters : character map application
gnome-chess : simple chess game
gnome-clocks : Simple GNOME app with stopwatch, timer, and world clock support
gnome-color-manager : Color management integration for the GNOME desktop environment
gnome-contacts : Contacts manager for GNOME
gnome-control-center : utilities to configure the GNOME desktop
gnome-control-center-data : configuration applets for GNOME - data files
gnome-core : GNOME Desktop Environment -- essential components
gnome-desktop3-data : Common files for GNOME desktop apps
gnome-disk-utility : manage and configure disk drives and media
gnome-font-viewer : font viewer for GNOME
gnome-games : games for the GNOME desktop
gnome-icon-theme : This package contains the default icon theme used by the GNOME
gnome-initial-setup : Initial GNOME system setup helper
gnome-keyring : GNOME keyring services (daemon and tools)
gnome-keyring-pkcs11:amd64 : GNOME keyring module for the PKCS#11 module loading library
gnome-klotski : Klotski puzzle game for GNOME
gnome-logs : viewer for the systemd journal
gnome-mahjongg : classic Eastern tile game for GNOME
gnome-maps : map application for GNOME
gnome-menus : GNOME implementation of the freedesktop menu specification
gnome-mines : popular minesweeper puzzle game for GNOME
gnome-music : Music is the new GNOME music playing application
gnome-nibbles : snake game, up to four players
gnome-online-accounts : service to manage online accounts for the GNOME desktop
gnome-remote-desktop : Remote desktop daemon for GNOME using PipeWire
gnome-robots : improved old BSD robots game
gnome-session : GNOME Session Manager - GNOME 3 session
gnome-session-bin : GNOME Session Manager - Minimal runtime
gnome-session-common : GNOME Session Manager - common files
gnome-settings-daemon : daemon handling the GNOME session settings
gnome-settings-daemon-common : daemon handling the GNOME session settings - common files
gnome-shell : graphical shell for the GNOME desktop
gnome-shell-common : common files for the GNOME graphical shell
gnome-shell-extension-prefs : tool to enable / disable GNOME Shell extensions
gnome-shell-extensions : Extensions to extend functionality of GNOME Shell
gnome-software : Software Center for GNOME
gnome-software-common : Software Center for GNOME (common files)
gnome-sound-recorder : simple and modern sound recorder for GNOME
gnome-sudoku : Sudoku puzzle game for GNOME
gnome-sushi : sushi is a quick previewer for nautilus
gnome-system-monitor : Process viewer and system resource monitor for GNOME
gnome-taquin : game to move tiles so that they reach their places
gnome-terminal : GNOME terminal emulator application
gnome-terminal-data : Data files for the GNOME terminal emulator
gnome-tetravex : put tiles on a board and match their edges together
gnome-text-editor : simple text editor for GNOME
gnome-themes-extra:amd64 : Adwaita GTK 2 theme — engine
gnome-themes-extra-data : Adwaita GTK 2 theme and Adwaita-dark GTK 3 theme — common files
gnome-tweaks : tool to adjust advanced configuration settings for GNOME
gnome-user-docs : GNOME Help
gnome-user-share : User level public file sharing via WebDAV
gnome-video-effects : Collection of GStreamer effects
gnome-weather : access current conditions and forecasts
gnupg : GNU privacy guard - a free PGP replacement
gnupg-l10n : GNU privacy guard - localization files
gnupg-utils : GNU privacy guard - utility programs
gpg : GNU Privacy Guard -- minimalist public key operations
gpg-agent : GNU privacy guard - cryptographic agent
gpg-wks-client : GNU privacy guard - Web Key Service client
gpg-wks-server : GNU privacy guard - Web Key Service server
gpgconf : GNU privacy guard - core configuration utilities
gpgsm : GNU privacy guard - S/MIME version
gpgv : GNU privacy guard - signature verification tool
grep : GNU grep, egrep and fgrep
grilo-plugins-0.3:amd64 : Framework for discovering and browsing media - Plugins
groff-base : GNU troff text-formatting system (base system components)
grub-common : GRand Unified Bootloader (common files)
grub-pc : GRand Unified Bootloader, version 2 (PC/BIOS version)
grub-pc-bin : GRand Unified Bootloader, version 2 (PC/BIOS modules)
grub2-common : GRand Unified Bootloader (common files for version 2)
gsettings-desktop-schemas : GSettings desktop-wide schemas
gsfonts : transitional dummy package (gsfonts -> fonts-urw-base35)
gstreamer1.0-clutter-3.0:amd64 : Clutter PLugin for GStreamer 1.0
gstreamer1.0-gl:amd64 : GStreamer plugins for GL
gstreamer1.0-gtk3:amd64 : GStreamer plugin for GTK+3
gstreamer1.0-libav:amd64 : ffmpeg plugin for GStreamer
gstreamer1.0-packagekit : GStreamer plugin to install codecs using PackageKit
gstreamer1.0-pipewire:amd64 : GStreamer 1.0 plugin for the PipeWire multimedia server
gstreamer1.0-plugins-bad:amd64 : GStreamer plugins from the "bad" set
gstreamer1.0-plugins-base:amd64 : GStreamer plugins from the "base" set
gstreamer1.0-plugins-good:amd64 : GStreamer plugins from the "good" set
gstreamer1.0-plugins-ugly:amd64 : GStreamer plugins from the "ugly" set
gstreamer1.0-x:amd64 : GStreamer plugins for X11 and Pango
gtk-update-icon-cache : icon theme caching utility
gtk2-engines-pixbuf:amd64 : pixbuf-based theme for GTK 2
guile-3.0-libs:amd64 : Core Guile libraries
gvfs:amd64 : userspace virtual filesystem - GIO module
gvfs-backends : userspace virtual filesystem - backends
gvfs-common : userspace virtual filesystem - common data files
gvfs-daemons : userspace virtual filesystem - servers
gvfs-fuse : userspace virtual filesystem - fuse server
gvfs-libs:amd64 : userspace virtual filesystem - private libraries
gzip : GNU compression utilities
hicolor-icon-theme : default fallback theme for FreeDesktop.org icon themes
hitori : logic puzzle game similar to sudoku
hoichess : xboard compatible chess engine to play chess with
hostname : utility to set/show the host name or domain name
hunspell-en-us : English_american dictionary for hunspell
hyphen-en-us : English (US) hyphenation patterns
i965-va-driver:amd64 : VAAPI driver for Intel G45 & HD Graphics family
i965-va-driver:i386 : VAAPI driver for Intel G45 & HD Graphics family
iagno : popular Othello game for GNOME
iamerican : American English dictionary for ispell (standard version)
ibritish : British English dictionary for ispell (standard version)
ibus : Intelligent Input Bus - core
ibus-data : Intelligent Input Bus - data files
ibus-gtk:amd64 : Intelligent Input Bus - GTK2 support
ibus-gtk3:amd64 : Intelligent Input Bus - GTK3 support
ibus-gtk4:amd64 : Intelligent Input Bus - GTK4 support
ienglish-common : Common files for British and American ispell dictionaries
ifupdown : high level tools to configure network interfaces
iio-sensor-proxy : IIO sensors to D-Bus proxy
im-config : Input method configuration framework
imagemagick-6-common : image manipulation programs -- infrastructure
inetutils-telnet : telnet client
init : metapackage ensuring an init system is installed
init-system-helpers : helper tools for all init systems
initramfs-tools : generic modular initramfs generator (automation)
initramfs-tools-core : generic modular initramfs generator (core tools)
installation-report : system installation report
intel-media-va-driver:amd64 : VAAPI driver for the Intel GEN8+ Graphics family
intel-media-va-driver:i386 : VAAPI driver for the Intel GEN8+ Graphics family
intel-microcode : Processor microcode firmware for Intel CPUs
ipp-usb : Daemon for IPP over USB printer support
iproute2 : networking and traffic control tools
iputils-ping : Tools to test the reachability of network hosts
isc-dhcp-client : DHCP client for automatically obtaining an IP address
isc-dhcp-common : common manpages relevant to all of the isc-dhcp packages
iso-codes : ISO language, territory, currency, script codes and their translations
ispell : International Ispell (an interactive spelling corrector)
iucode-tool : Intel processor microcode tool
iw : tool for configuring Linux wireless devices
java-common : Base package for Java runtimes
javascript-common : Base support for JavaScript library packages
jq : lightweight and flexible command-line JSON processor
kbd : Linux console font and keytable utilities
keyboard-configuration : system-wide keyboard preferences
klibc-utils : small utilities built with klibc for early boot
kmod : tools for managing Linux kernel modules
krb5-locales : internationalization support for MIT Kerberos
laptop-detect : system chassis type checker
less : pager program similar to more
liba52-0.7.4:amd64 : library for decoding ATSC A/52 streams
libaa1:amd64 : ASCII art library
libaacs0:amd64 : free-and-libre implementation of AACS
libabsl20220623:amd64 : extensions to the C++ standard library
libabw-0.1-1:amd64 : library for reading and writing AbiWord(tm) documents
libaccountsservice0:amd64 : query and manipulate user account information - shared libraries
libacl1:amd64 : access control list - shared library
libadwaita-1-0:amd64 : Library with GTK widgets for mobile phones
libao-common : Cross Platform Audio Output Library (Common files)
libao4:amd64 : Cross Platform Audio Output Library
libaom3:amd64 : AV1 Video Codec Library
libaom3:i386 : AV1 Video Codec Library
libapache2-mod-dnssd : Zeroconf support for Apache 2 via avahi
libapparmor1:amd64 : changehat AppArmor library
libappstream4:amd64 : Library to access AppStream services
libapr1:amd64 : Apache Portable Runtime Library
libaprutil1:amd64 : Apache Portable Runtime Utility Library
libaprutil1-dbd-sqlite3:amd64 : Apache Portable Runtime Utility Library - SQLite3 Driver
libaprutil1-ldap:amd64 : Apache Portable Runtime Utility Library - LDAP Driver
libapt-pkg6.0:amd64 : package management runtime library
libarchive13:amd64 : Multi-format archive and compression library (shared library)
libargon2-1:amd64 : memory-hard hashing function - runtime library
libasound2:amd64 : shared library for ALSA applications
libasound2:i386 : shared library for ALSA applications
libasound2-data : Configuration files and profiles for ALSA drivers
libasound2-plugins:amd64 : ALSA library additional plugins
libasound2-plugins:i386 : ALSA library additional plugins
libaspell15:amd64 : GNU Aspell spell-checker runtime library
libass9:amd64 : library for SSA/ASS subtitles rendering
libassuan0:amd64 : IPC library for the GnuPG components
libasyncns0:amd64 : Asynchronous name service query library
libasyncns0:i386 : Asynchronous name service query library
libatasmart4:amd64 : ATA S.M.A.R.T. reading and parsing library
libatk-adaptor:amd64 : AT-SPI 2 toolkit bridge
libatk-bridge2.0-0:amd64 : AT-SPI 2 toolkit bridge - shared library
libatk-wrapper-java : ATK implementation for Java using JNI
libatk-wrapper-java-jni:amd64 : ATK implementation for Java using JNI (JNI bindings)
libatk1.0-0:amd64 : ATK accessibility toolkit
libatkmm-1.6-1v5:amd64 : C++ wrappers for ATK accessibility toolkit (shared libraries)
libatomic1:amd64 : support library providing __atomic built-in functions
libatomic1:i386 : support library providing __atomic built-in functions
libatopology2:amd64 : shared library for handling ALSA topology definitions
libatspi2.0-0:amd64 : Assistive Technology Service Provider Interface - shared library
libattr1:amd64 : extended attribute handling - shared library
libaudio2:amd64 : Network Audio System - shared libraries
libaudit-common : Dynamic library for security auditing - common files
libaudit1:amd64 : Dynamic library for security auditing
libauthen-sasl-perl : Authen::SASL - SASL Authentication framework
libavahi-client3:amd64 : Avahi client library
libavahi-common-data:amd64 : Avahi common data files
libavahi-common3:amd64 : Avahi common library
libavahi-core7:amd64 : Avahi's embeddable mDNS/DNS-SD library
libavahi-glib1:amd64 : Avahi GLib integration library
libavc1394-0:amd64 : control IEEE 1394 audio/video devices
libavcodec59:amd64 : FFmpeg library with de/encoders for audio/video codecs - runtime files
libavcodec59:i386 : FFmpeg library with de/encoders for audio/video codecs - runtime files
libavfilter8:amd64 : FFmpeg library containing media filters - runtime files
libavformat59:amd64 : FFmpeg library with (de)muxers for multimedia containers - runtime files
libavif15:amd64 : Library for handling .avif files
libavutil57:amd64 : FFmpeg library with functions for simplifying programming - runtime files
libavutil57:i386 : FFmpeg library with functions for simplifying programming - runtime files
libayatana-appindicator3-1 : Ayatana Application Indicators (GTK-3+ version)
libayatana-ido3-0.4-0:amd64 : Widgets and other objects used for Ayatana Indicators
libayatana-indicator3-7:amd64 : panel indicator applet - shared library (GTK-3+ variant)
libbdplus0:amd64 : implementation of BD+ for reading Blu-ray Discs
libblas3:amd64 : Basic Linear Algebra Reference implementations, shared library
libblkid1:amd64 : block device ID library
libblkid1:i386 : block device ID library
libblockdev-crypto2:amd64 : Crypto plugin for libblockdev
libblockdev-fs2:amd64 : file system plugin for libblockdev
libblockdev-loop2:amd64 : Loop device plugin for libblockdev
libblockdev-part-err2:amd64 : Partition error utility functions for libblockdev
libblockdev-part2:amd64 : Partitioning plugin for libblockdev
libblockdev-swap2:amd64 : Swap plugin for libblockdev
libblockdev-utils2:amd64 : Utility functions for libblockdev
libblockdev2:amd64 : Library for manipulating block devices
libbluetooth3:amd64 : Library to use the BlueZ Linux Bluetooth stack
libbluray2:amd64 : Blu-ray disc playback support library (shared library)
libboost-filesystem1.74.0:amd64 : filesystem operations (portable paths, iteration over directories, etc) in C++
libboost-iostreams1.74.0:amd64 : Boost.Iostreams Library
libboost-locale1.74.0:amd64 : C++ facilities for localization
libboost-thread1.74.0:amd64 : portable C++ multi-threading
libbox2d2:amd64 : 2D physics engine
libbpf1:amd64 : eBPF helper library (shared library)
libbrasero-media3-1:amd64 : CD/DVD burning library for GNOME - runtime
libbrlapi0.8:amd64 : braille display access via BRLTTY - shared library
libbrotli1:amd64 : library implementing brotli encoder and decoder (shared libraries)
libbrotli1:i386 : library implementing brotli encoder and decoder (shared libraries)
libbs2b0:amd64 : Bauer stereophonic-to-binaural DSP library
libbsd0:amd64 : utility functions from BSD systems - shared library
libbsd0:i386 : utility functions from BSD systems - shared library
libburn4:amd64 : library to provide CD/DVD/BD writing functions
libbz2-1.0:amd64 : high-quality block-sorting file compressor library - runtime
libc-bin : GNU C Library: Binaries
libc-l10n : GNU C Library: localization files
libc6:amd64 : GNU C Library: Shared libraries
libc6:i386 : GNU C Library: Shared libraries
libcaca0:amd64 : colour ASCII art library
libcairo-gobject-perl : integrate Cairo into the Glib type system in Perl
libcairo-gobject2:amd64 : Cairo 2D vector graphics library (GObject library)
libcairo-gobject2:i386 : Cairo 2D vector graphics library (GObject library)
libcairo-perl : Perl interface to the Cairo graphics library
libcairo-script-interpreter2:amd64 : Cairo 2D vector graphics library (script interpreter)
libcairo2:amd64 : Cairo 2D vector graphics library
libcairo2:i386 : Cairo 2D vector graphics library
libcairomm-1.0-1v5:amd64 : C++ wrappers for Cairo (shared libraries)
libcamel-1.2-64:amd64 : Evolution MIME message handling library
libcanberra-gtk3-0:amd64 : GTK+ 3.0 helper for playing widget event sounds with libcanberra
libcanberra-gtk3-module:amd64 : translates GTK3 widgets signals to event sounds
libcanberra-pulse:amd64 : PulseAudio backend for libcanberra
libcanberra0:amd64 : simple abstract interface for playing event sounds
libcap-ng0:amd64 : alternate POSIX capabilities library
libcap2:amd64 : POSIX 1003.1e capabilities (library)
libcap2:i386 : POSIX 1003.1e capabilities (library)
libcap2-bin : POSIX 1003.1e capabilities (utilities)
libcbor0.8:amd64 : library for parsing and generating CBOR (RFC 7049)
libcdio-cdda2:amd64 : library to read and control digital audio CDs
libcdio-paranoia2:amd64 : library to read digital audio CDs with error correction
libcdio19:amd64 : library to read and control CD-ROM
libcdparanoia0:amd64 : audio extraction tool for sampling CDs (library)
libcdr-0.1-1:amd64 : library for reading and converting Corel DRAW files
libcheese-gtk25:amd64 : tool to take pictures and videos from your webcam - widgets
libcheese8:amd64 : tool to take pictures and videos from your webcam - base library
libchromaprint1:amd64 : audio fingerprint library
libcjson1:amd64 : Ultralightweight JSON parser in ANSI C
libclone-perl:amd64 : module for recursively copying Perl datatypes
libcloudproviders0:amd64 : cloud provider library
libclucene-contribs1v5:amd64 : language specific text analyzers (runtime)
libclucene-core1v5:amd64 : core library for full-featured text search engine (runtime)
libclutter-1.0-0:amd64 : Open GL based interactive canvas library
libclutter-1.0-common : Open GL based interactive canvas library (common files)
libclutter-gst-3.0-0:amd64 : Open GL based interactive canvas library GStreamer elements
libclutter-gtk-1.0-0:amd64 : Open GL based interactive canvas library GTK+ widget
libcmark0.30.2:amd64 : CommonMark parsing and rendering library
libcodec2-1.0:amd64 : Codec2 runtime library
libcodec2-1.0:i386 : Codec2 runtime library
libcogl-common : Object oriented GL/GLES Abstraction/Utility Layer (common files)
libcogl-pango20:amd64 : Object oriented GL/GLES Abstraction/Utility Layer
libcogl-path20:amd64 : Object oriented GL/GLES Abstraction/Utility Layer
libcogl20:amd64 : Object oriented GL/GLES Abstraction/Utility Layer
libcolamd2:amd64 : column approximate minimum degree ordering library for sparse matrices
libcolord-gtk4-1:amd64 : GTK4 convenience library for interacting with colord
libcolord2:amd64 : system service to manage device colour profiles -- runtime
libcolorhug2:amd64 : library to access the ColorHug colourimeter -- runtime
libcom-err2:amd64 : common error description library
libcrack2:amd64 : pro-active password checker library
libcrypt1:amd64 : libcrypt shared library
libcrypt1:i386 : libcrypt shared library
libcryptsetup12:amd64 : disk encryption support - shared library
libcue2:amd64 : CUE Sheet Parser Library
libcups2:amd64 : Common UNIX Printing System(tm) - Core library
libcupsfilters1:amd64 : OpenPrinting CUPS Filters - Shared library
libcurl3-gnutls:amd64 : easy-to-use client-side URL transfer library (GnuTLS flavour)
libcurl4:amd64 : easy-to-use client-side URL transfer library (OpenSSL flavour)
libdaemon0:amd64 : lightweight C library for daemons - runtime library
libdata-dump-perl : Perl module to help dump data structures
libdatrie1:amd64 : Double-array trie library
libdatrie1:i386 : Double-array trie library
libdav1d6:amd64 : fast and small AV1 video stream decoder (shared library)
libdav1d6:i386 : fast and small AV1 video stream decoder (shared library)
libdb5.3:amd64 : Berkeley v5.3 Database Libraries [runtime]
libdb5.3:i386 : Berkeley v5.3 Database Libraries [runtime]
libdbus-1-3:amd64 : simple interprocess messaging system (library)
libdbus-1-3:i386 : simple interprocess messaging system (library)
libdbusmenu-glib4:amd64 : library for passing menus over DBus
libdbusmenu-gtk3-4:amd64 : library for passing menus over DBus - GTK-3+ version
libdc1394-25:amd64 : high level programming interface for IEEE 1394 digital cameras
libdca0:amd64 : decoding library for DTS Coherent Acoustics streams
libdconf1:amd64 : simple configuration storage system - runtime library
libde265-0:amd64 : Open H.265 video codec implementation
libdebconfclient0:amd64 : Debian Configuration Management System (C-implementation library)
libdecor-0-0:amd64 : client-side window decoration library
libdecor-0-plugin-1-cairo:amd64 : default decoration plugin
libdee-1.0-4:amd64 : Model to synchronize multiple instances over DBus - shared lib
libdeflate0:amd64 : fast, whole-buffer DEFLATE-based compression and decompression
libdeflate0:i386 : fast, whole-buffer DEFLATE-based compression and decompression
libdevmapper1.02.1:amd64 : Linux Kernel Device Mapper userspace library
libdirectfb-1.7-7:amd64 : direct frame buffer graphics (shared libraries)
libdiscover2 : hardware identification library
libdjvulibre-text : Linguistic support files for libdjvulibre
libdjvulibre21:amd64 : Runtime support for the DjVu image format
libdmapsharing-3.0-2:amd64 : DMAP client and server library - runtime
libdotconf0:amd64 : Configuration file parser library - runtime files
libdrm-amdgpu1:amd64 : Userspace interface to amdgpu-specific kernel DRM services -- runtime
libdrm-amdgpu1:i386 : Userspace interface to amdgpu-specific kernel DRM services -- runtime
libdrm-common : Userspace interface to kernel DRM services -- common files
libdrm-intel1:amd64 : Userspace interface to intel-specific kernel DRM services -- runtime
libdrm-intel1:i386 : Userspace interface to intel-specific kernel DRM services -- runtime
libdrm-nouveau2:amd64 : Userspace interface to nouveau-specific kernel DRM services -- runtime
libdrm-nouveau2:i386 : Userspace interface to nouveau-specific kernel DRM services -- runtime
libdrm-radeon1:amd64 : Userspace interface to radeon-specific kernel DRM services -- runtime
libdrm-radeon1:i386 : Userspace interface to radeon-specific kernel DRM services -- runtime
libdrm2:amd64 : Userspace interface to kernel DRM services -- runtime
libdrm2:i386 : Userspace interface to kernel DRM services -- runtime
libduktape207:amd64 : embeddable Javascript engine, library
libdv4:amd64 : software library for DV format digital video (runtime lib)
libdvdnav4:amd64 : DVD navigation library
libdvdread8:amd64 : library for reading DVDs
libdw1:amd64 : library that provides access to the DWARF debug information
libe-book-0.1-1:amd64 : library for reading and converting various  e-book formats
libebackend-1.2-11:amd64 : Utility library for evolution data servers
libebook-1.2-21:amd64 : Client library for evolution address books
libebook-contacts-1.2-4:amd64 : Client library for evolution contacts books
libecal-2.0-2:amd64 : Client library for evolution calendars
libedata-book-1.2-27:amd64 : Backend library for evolution address books
libedata-cal-2.0-2:amd64 : Backend library for evolution calendars
libedataserver-1.2-27:amd64 : Utility library for evolution data servers
libedataserverui-1.2-4:amd64 : Utility library for evolution data servers
libedataserverui4-1.0-0:amd64 : GTK4 utility library for evolution data servers
libedit2:amd64 : BSD editline and history libraries
libedit2:i386 : BSD editline and history libraries
libeditorconfig0:amd64 : coding style indenter across editors - library
libefiboot1:amd64 : Library to manage UEFI variables
libefivar1:amd64 : Library to manage UEFI variables
libegl-mesa0:amd64 : free implementation of the EGL API -- Mesa vendor library
libegl-mesa0:i386 : free implementation of the EGL API -- Mesa vendor library
libegl1:amd64 : Vendor neutral GL dispatch library -- EGL support
libegl1:i386 : Vendor neutral GL dispatch library -- EGL support
libelf1:amd64 : library to read and write ELF files
libelf1:i386 : library to read and write ELF files
libenchant-2-2:amd64 : Wrapper library for various spell checker engines (runtime libs)
libencode-locale-perl : utility to determine the locale encoding
libeot0:amd64 : Library for parsing/converting Embedded OpenType files
libepoxy0:amd64 : OpenGL function pointer management library
libept1.6.0:amd64 : High-level library for managing Debian package information
libepubgen-0.1-1:amd64 : EPUB generator library
liberror-perl : Perl module for error/exception handling in an OO-ish way
libespeak-ng1:amd64 : Multi-lingual software speech synthesizer: shared library
libetonyek-0.1-1:amd64 : library for reading and converting Apple Keynote presentations
libevdev2:amd64 : wrapper library for evdev devices
libevdocument3-4:amd64 : Document (PostScript, PDF) rendering library
libevent-2.1-7:amd64 : Asynchronous event notification library
libevolution : evolution libraries
libevview3-3:amd64 : Document (PostScript, PDF) rendering library - Gtk+ widgets
libexempi8:amd64 : library to parse XMP metadata (Library)
libexif12:amd64 : library to parse EXIF files
libexiv2-27:amd64 : EXIF/IPTC/XMP metadata manipulation library
libexpat1:amd64 : XML parsing C library - runtime library
libexpat1:i386 : XML parsing C library - runtime library
libext2fs2:amd64 : ext2/ext3/ext4 file system libraries
libexttextcat-2.0-0:amd64 : Language detection library
libexttextcat-data : Language detection library - data files
libextutils-depends-perl : Perl module for building extensions that depend on other extensions
libfaad2:amd64 : freeware Advanced Audio Decoder - runtime files
libfdisk1:amd64 : fdisk partitioning library
libffi8:amd64 : Foreign Function Interface library runtime
libffi8:i386 : Foreign Function Interface library runtime
libfftw3-double3:amd64 : Library for computing Fast Fourier Transforms - Double precision
libfftw3-single3:amd64 : Library for computing Fast Fourier Transforms - Single precision
libfido2-1:amd64 : library for generating and verifying FIDO 2.0 objects
libfile-basedir-perl : Perl module to use the freedesktop basedir specification
libfile-desktopentry-perl : Perl module to handle freedesktop .desktop files
libfile-listing-perl : module to parse directory listings
libfile-mimeinfo-perl : Perl module to determine file types
libflac12:amd64 : Free Lossless Audio Codec - runtime C library
libflac12:i386 : Free Lossless Audio Codec - runtime C library
libflashrom1:amd64 : Identify, read, write, erase, and verify BIOS/ROM/flash chips - library
libflatpak0:amd64 : Application deployment framework for desktop apps (library)
libflite1:amd64 : Small run-time speech synthesis engine - shared libraries
libfluidsynth3:amd64 : Real-time MIDI software synthesizer (runtime library)
libfolks-eds26:amd64 : Evolution-data-server backend for libfolks
libfolks26:amd64 : library to aggregates people into metacontacts
libfont-afm-perl : Perl interface to Adobe Font Metrics files
libfontconfig1:amd64 : generic font configuration library - runtime
libfontconfig1:i386 : generic font configuration library - runtime
libfontembed1:amd64 : OpenPrinting CUPS Filters - Font Embed Shared library
libfontenc1:amd64 : X11 font encoding library
libfreeaptx0:amd64 : Free implementation of aptX
libfreehand-0.1-1 : Library for parsing the FreeHand file format structure
libfreerdp-server2-2:amd64 : Free Remote Desktop Protocol library (server library)
libfreerdp2-2:amd64 : Free Remote Desktop Protocol library (core library)
libfreetype6:amd64 : FreeType 2 font engine, shared library files
libfreetype6:i386 : FreeType 2 font engine, shared library files
libfribidi0:amd64 : Free Implementation of the Unicode BiDi algorithm
libfribidi0:i386 : Free Implementation of the Unicode BiDi algorithm
libfstrm0:amd64 : Frame Streams (fstrm) library
libftdi1-2:amd64 : C Library to control and program the FTDI USB controllers
libfuse2:amd64 : Filesystem in Userspace (library)
libfuse3-3:amd64 : Filesystem in Userspace (library) (3.x version)
libfwupd2:amd64 : Firmware update daemon library
libgail-3-0:amd64 : GNOME Accessibility Implementation Library -- shared libraries
libgail-common:amd64 : GNOME Accessibility Implementation Library -- common modules
libgail18:amd64 : GNOME Accessibility Implementation Library -- shared libraries
libgav1-1:amd64 : AV1 decoder developed by Google -- runtime library
libgbm1:amd64 : generic buffer management API -- runtime
libgbm1:i386 : generic buffer management API -- runtime
libgc1:amd64 : conservative garbage collector for C and C++
libgcab-1.0-0:amd64 : Microsoft Cabinet file manipulation library
libgcc-s1:amd64 : GCC support library
libgcc-s1:i386 : GCC support library
libgck-1-0:amd64 : Glib wrapper library for PKCS#11 - runtime
libgcr-base-3-1:amd64 : Library for Crypto related tasks
libgcr-ui-3-1:amd64 : Library for Crypto UI related tasks
libgcrypt20:amd64 : LGPL Crypto library - runtime library
libgcrypt20:i386 : LGPL Crypto library - runtime library
libgd3:amd64 : GD Graphics Library
libgdata-common : Library for accessing GData webservices - common data files
libgdata22:amd64 : Library for accessing GData webservices - shared libraries
libgdbm-compat4:amd64 : GNU dbm database routines (legacy support runtime version) 
libgdbm6:amd64 : GNU dbm database routines (runtime version) 
libgdk-pixbuf-2.0-0:amd64 : GDK Pixbuf library
libgdk-pixbuf-2.0-0:i386 : GDK Pixbuf library
libgdk-pixbuf-xlib-2.0-0:amd64 : GDK Pixbuf library (deprecated Xlib integration)
libgdk-pixbuf2.0-0:amd64 : GDK Pixbuf library (transitional package)
libgdk-pixbuf2.0-bin : GDK Pixbuf library (thumbnailer)
libgdk-pixbuf2.0-common : GDK Pixbuf library - data files
libgdm1 : GNOME Display Manager (shared library)
libgee-0.8-2:amd64 : GObject based collection and utility library
libgeoclue-2-0:amd64 : convenience library to interact with geoinformation service
libgeocode-glib-2-0:amd64 : geocoding and reverse geocoding GLib library using Nominatim
libges-1.0-0 : GStreamer editing services (shared library)
libgexiv2-2:amd64 : GObject-based wrapper around the Exiv2 library
libgfortran5:amd64 : Runtime library for GNU Fortran applications
libgif7:amd64 : library for GIF images (library)
libgirepository-1.0-1:amd64 : Library for handling GObject introspection data (runtime library)
libgjs0g:amd64 : Mozilla-based javascript bindings for the GNOME platform
libgl1:amd64 : Vendor neutral GL dispatch library -- legacy GL support
libgl1:i386 : Vendor neutral GL dispatch library -- legacy GL support
libgl1-mesa-dri:amd64 : free implementation of the OpenGL API -- DRI modules
libgl1-mesa-dri:i386 : free implementation of the OpenGL API -- DRI modules
libglapi-mesa:amd64 : free implementation of the GL API -- shared library
libglapi-mesa:i386 : free implementation of the GL API -- shared library
libgles2:amd64 : Vendor neutral GL dispatch library -- GLESv2 support
libglib-object-introspection-perl : Perl bindings for gobject-introspection libraries
libglib-perl:amd64 : interface to the GLib and GObject libraries
libglib2.0-0:amd64 : GLib library of C routines
libglib2.0-0:i386 : GLib library of C routines
libglib2.0-bin : Programs for the GLib library
libglib2.0-data : Common files for GLib library
libglibmm-2.4-1v5:amd64 : C++ wrapper for the GLib toolkit (shared libraries)
libglu1-mesa:amd64 : Mesa OpenGL utility library (GLU)
libglvnd0:amd64 : Vendor neutral GL dispatch library
libglvnd0:i386 : Vendor neutral GL dispatch library
libglx-mesa0:amd64 : free implementation of the OpenGL API -- GLX vendor library
libglx-mesa0:i386 : free implementation of the OpenGL API -- GLX vendor library
libglx0:amd64 : Vendor neutral GL dispatch library -- GLX support
libglx0:i386 : Vendor neutral GL dispatch library -- GLX support
libgme0:amd64 : Playback library for video game music files - shared library
libgmp10:amd64 : Multiprecision arithmetic library
libgmp10:i386 : Multiprecision arithmetic library
libgnome-autoar-0-0:amd64 : Archives integration support for GNOME
libgnome-autoar-gtk-0-0:amd64 : GTK+ widgets for the GNOME Autoar library
libgnome-bg-4-2:amd64 : Utility library for background images - runtime files
libgnome-bluetooth-3.0-13:amd64 : GNOME Bluetooth 3 support library
libgnome-bluetooth-ui-3.0-13:amd64 : GNOME Bluetooth 3 UI support library
libgnome-desktop-3-20:amd64 : Utility library for the GNOME desktop - GTK 3 version
libgnome-desktop-4-2:amd64 : Utility library for the GNOME desktop - runtime files
libgnome-games-support-1-3:amd64 : library for common functions of GNOME games
libgnome-games-support-common : library for common functions of GNOME games (common files)
libgnome-menu-3-0:amd64 : GNOME implementation of the freedesktop menu specification
libgnome-rr-4-2:amd64 : Utility library for display information - runtime files
libgnomekbd-common : GNOME library to manage keyboard configuration - common files
libgnomekbd8:amd64 : GNOME library to manage keyboard configuration - shared library
libgnutls30:amd64 : GNU TLS library - main runtime library
libgnutls30:i386 : GNU TLS library - main runtime library
libgoa-1.0-0b:amd64 : library for GNOME Online Accounts
libgoa-1.0-common : library for GNOME Online Accounts - common files
libgoa-backend-1.0-1:amd64 : backend library for GNOME Online Accounts
libgom-1.0-0:amd64 : Object mapper from GObjects to SQLite
libgomp1:amd64 : GCC OpenMP (GOMP) support library
libgomp1:i386 : GCC OpenMP (GOMP) support library
libgpg-error-l10n : library of error values and messages in GnuPG (localization files)
libgpg-error0:amd64 : GnuPG development runtime library
libgpg-error0:i386 : GnuPG development runtime library
libgpgme11:amd64 : GPGME - GnuPG Made Easy (library)
libgpgmepp6:amd64 : C++ wrapper library for GPGME
libgphoto2-6:amd64 : gphoto2 digital camera library
libgphoto2-l10n : gphoto2 digital camera library - localized messages
libgphoto2-port12:amd64 : gphoto2 digital camera port library
libgpm2:amd64 : General Purpose Mouse - shared library
libgpod-common : common files for libgpod
libgpod4:amd64 : library to read and write songs and artwork to an iPod
libgraphene-1.0-0:amd64 : library of graphic data types
libgraphite2-3:amd64 : Font rendering engine for Complex Scripts -- library
libgraphite2-3:i386 : Font rendering engine for Complex Scripts -- library
libgrilo-0.3-0:amd64 : Framework for discovering and browsing media - Shared libraries
libgs-common : interpreter for the PostScript language and for PDF - ICC profiles
libgs10:amd64 : interpreter for the PostScript language and for PDF - Library
libgs10-common : interpreter for the PostScript language and for PDF - common files
libgsf-1-114:amd64 : Structured File Library - runtime version
libgsf-1-common : Structured File Library - common files
libgsf-bin : Structured File Library - programs
libgsl27:amd64 : GNU Scientific Library (GSL) -- library package
libgslcblas0:amd64 : GNU Scientific Library (GSL) -- blas library package
libgsm1:amd64 : Shared libraries for GSM speech compressor
libgsm1:i386 : Shared libraries for GSM speech compressor
libgsound0:amd64 : small library for playing system sounds
libgspell-1-2:amd64 : spell-checking library for GTK+ applications
libgspell-1-common : libgspell architecture-independent files
libgssapi-krb5-2:amd64 : MIT Kerberos runtime libraries - krb5 GSS-API Mechanism
libgssdp-1.6-0:amd64 : GObject-based library for SSDP
libgstreamer-gl1.0-0:amd64 : GStreamer GL libraries
libgstreamer-plugins-bad1.0-0:amd64 : GStreamer libraries from the "bad" set
libgstreamer-plugins-base1.0-0:amd64 : GStreamer libraries from the "base" set
libgstreamer1.0-0:amd64 : Core GStreamer libraries and elements
libgtk-3-0:amd64 : GTK graphical user interface library
libgtk-3-bin : programs for the GTK graphical user interface library
libgtk-3-common : common files for the GTK graphical user interface library
libgtk-4-1:amd64 : GTK graphical user interface library
libgtk-4-bin : programs for the GTK graphical user interface library
libgtk-4-common : common files for the GTK graphical user interface library
libgtk2.0-0:amd64 : GTK graphical user interface library - old version
libgtk2.0-bin : programs for the GTK graphical user interface library
libgtk2.0-common : common files for the GTK graphical user interface library
libgtk3-perl : Perl bindings for the GTK+ graphical user interface library
libgtkmm-3.0-1v5:amd64 : C++ wrappers for GTK+ (shared libraries)
libgtksourceview-4-0:amd64 : shared libraries for the GTK+ syntax highlighting widget
libgtksourceview-4-common : common files for the GTK+ syntax highlighting widget
libgtksourceview-5-0:amd64 : shared libraries for the GTK 4 syntax highlighting widget
libgtksourceview-5-common : common files for the GTK 4 syntax highlighting widget
libgtop-2.0-11:amd64 : gtop system monitoring library (shared)
libgtop2-common : gtop system monitoring library (common)
libgudev-1.0-0:amd64 : GObject-based wrapper library for libudev
libgupnp-1.6-0:amd64 : GObject-based library for UPnP
libgupnp-av-1.0-3 : Audio/Visual utility library for GUPnP
libgupnp-dlna-2.0-4 : DLNA utility library for GUPnP
libgupnp-igd-1.0-4:amd64 : library to handle UPnP IGD port mapping
libgusb2:amd64 : GLib wrapper around libusb1
libgweather-4-0:amd64 : GWeather shared library
libgweather-4-common : GWeather common files
libgxps2:amd64 : handling and rendering XPS documents (library)
libhandy-1-0:amd64 : Library with GTK widgets for mobile phones
libharfbuzz-icu0:amd64 : OpenType text shaping engine ICU backend
libharfbuzz0b:amd64 : OpenType text shaping engine (shared library)
libharfbuzz0b:i386 : OpenType text shaping engine (shared library)
libheif1:amd64 : ISO/IEC 23008-12:2017 HEIF file format decoder - shared library
libhogweed6:amd64 : low level cryptographic library (public-key cryptos)
libhogweed6:i386 : low level cryptographic library (public-key cryptos)
libhtml-form-perl : module that represents an HTML form element
libhtml-format-perl : module for transforming HTML into various formats
libhtml-parser-perl:amd64 : collection of modules that parse HTML text documents
libhtml-tagset-perl : data tables pertaining to HTML
libhtml-tree-perl : Perl module to represent and create HTML syntax trees
libhttp-cookies-perl : HTTP cookie jars
libhttp-daemon-perl : simple http server class
libhttp-date-perl : module of date conversion routines
libhttp-message-perl : perl interface to HTTP style messages
libhttp-negotiate-perl : implementation of content negotiation
libhunspell-1.7-0:amd64 : spell checker and morphological analyzer (shared library)
libhwy1:amd64 : Efficient and performance-portable SIMD wrapper (runtime files)
libhwy1:i386 : Efficient and performance-portable SIMD wrapper (runtime files)
libhyphen0:amd64 : ALTLinux hyphenation library - shared library
libibus-1.0-5:amd64 : Intelligent Input Bus - shared library
libical3:amd64 : iCalendar library implementation in C (runtime)
libice6:amd64 : X11 Inter-Client Exchange library
libicu72:amd64 : International Components for Unicode
libicu72:i386 : International Components for Unicode
libidn12:amd64 : GNU Libidn library, implementation of IETF IDN specifications
libidn2-0:amd64 : Internationalized domain names (IDNA2008/TR46) library
libidn2-0:i386 : Internationalized domain names (IDNA2008/TR46) library
libiec61883-0:amd64 : partial implementation of IEC 61883 (shared lib)
libieee1284-3:amd64 : cross-platform library for parallel port access
libigdgmm12:amd64 : Intel Graphics Memory Management Library -- shared library
libigdgmm12:i386 : Intel Graphics Memory Management Library -- shared library
libijs-0.35:amd64 : IJS raster image transport protocol: shared library
libimath-3-1-29:amd64 : Utility libraries from ASF used by OpenEXR - runtime
libimobiledevice6:amd64 : Library for communicating with iPhone and other Apple devices
libinput-bin : input device management and event handling library - udev quirks
libinput10:amd64 : input device management and event handling library - shared library
libinstpatch-1.0-2:amd64 : MIDI instrument editing library
libio-html-perl : open an HTML file with automatic charset detection
libio-socket-ssl-perl : Perl module implementing object oriented interface to SSL sockets
libio-stringy-perl : modules for I/O on in-core objects (strings/arrays)
libip4tc2:amd64 : netfilter libip4tc library
libipc-system-simple-perl : Perl module to run commands simply, with detailed diagnostics
libiptcdata0 : Library to parse IPTC metadata
libisl23:amd64 : manipulating sets and relations of integer points bounded by linear constraints
libisofs6:amd64 : library to create ISO 9660 images
libiw30:amd64 : Wireless tools - library
libjack-jackd2-0:amd64 : JACK Audio Connection Kit (libraries)
libjack-jackd2-0:i386 : JACK Audio Connection Kit (libraries)
libjansson4:amd64 : C library for encoding, decoding and manipulating JSON data
libjavascriptcoregtk-4.0-18:amd64 : JavaScript engine library from WebKitGTK
libjavascriptcoregtk-4.1-0:amd64 : JavaScript engine library from WebKitGTK
libjavascriptcoregtk-6.0-1:amd64 : JavaScript engine library from WebKitGTK
libjaylink0:amd64 : library for interacting with J-Link programmers
libjbig0:amd64 : JBIGkit libraries
libjbig0:i386 : JBIGkit libraries
libjbig2dec0:amd64 : JBIG2 decoder library - shared libraries
libjcat1:amd64 : JSON catalog library
libjemalloc2:amd64 : general-purpose scalable concurrent malloc(3) implementation
libjim0.81:amd64 : small-footprint implementation of Tcl - shared library
libjpeg62-turbo:amd64 : libjpeg-turbo JPEG runtime library
libjpeg62-turbo:i386 : libjpeg-turbo JPEG runtime library
libjq1:amd64 : lightweight and flexible command-line JSON processor - shared library
libjs-jquery : JavaScript library for dynamic web applications
libjson-c5:amd64 : JSON manipulation library - shared library
libjson-glib-1.0-0:amd64 : GLib JSON manipulation library
libjson-glib-1.0-common : GLib JSON manipulation library (common files)
libjte2:amd64 : Jigdo Template Export - runtime library
libjxl0.7:amd64 : JPEG XL Image Coding System - "JXL" (shared libraries)
libjxl0.7:i386 : JPEG XL Image Coding System - "JXL" (shared libraries)
libjxr-tools : JPEG-XR lib - command line apps
libjxr0:amd64 : JPEG-XR lib - libraries
libk5crypto3:amd64 : MIT Kerberos runtime libraries - Crypto Library
libkate1:amd64 : Codec for karaoke and text encapsulation
libkeyutils1:amd64 : Linux Key Management Utilities (library)
libklibc:amd64 : minimal libc subset for use with initramfs
libkmod2:amd64 : libkmod shared library
libkpathsea6:amd64 : TeX Live: path search library for TeX (runtime part)
libkrb5-3:amd64 : MIT Kerberos runtime libraries
libkrb5support0:amd64 : MIT Kerberos runtime libraries - Support library
libksba8:amd64 : X.509 and CMS support library
liblangtag-common : library to access tags for identifying languages -- data
liblangtag1:amd64 : library to access tags for identifying languages
liblapack3:amd64 : Library of linear algebra routines 3 - shared version
liblc3-0:amd64 : Low Complexity Communication Codec (shared library)
liblcms2-2:amd64 : Little CMS 2 color management library
liblcms2-2:i386 : Little CMS 2 color management library
libldacbt-abr2:amd64 : LDAC Bluetooth ABR library (shared library)
libldacbt-enc2:amd64 : LDAC Bluetooth encoder library (shared library)
libldap-2.5-0:amd64 : OpenLDAP libraries
libldap-common : OpenLDAP common files for libraries
libldb2:amd64 : LDAP-like embedded database - shared library
liblerc4:amd64 : Limited Error Raster Compression library
liblerc4:i386 : Limited Error Raster Compression library
liblilv-0-0:amd64 : library for simple use of LV2 plugins
liblirc-client0:amd64 : infra-red remote control support - client library
libllvm15:amd64 : Modular compiler and toolchain technologies, runtime library
libllvm15:i386 : Modular compiler and toolchain technologies, runtime library
liblmdb0:amd64 : Lightning Memory-Mapped Database shared library
liblocale-gettext-perl : module using libc functions for internationalization in Perl
liblockfile-bin : support binaries for and cli utilities based on liblockfile
liblouis-data : Braille translation library - data
liblouis20:amd64 : Braille translation library - shared libs
liblouisutdml-bin : Braille UTDML translation utilities
liblouisutdml-data : Braille UTDML translation library - data
liblouisutdml9:amd64 : Braille UTDML translation library - shared libs
liblqr-1-0:amd64 : converts plain array images into multi-size representation
liblrdf0:amd64 : library to manipulate RDF files describing LADSPA plugins
libltc11:amd64 : linear timecode library
libltdl7:amd64 : System independent dlopen wrapper for GNU libtool
liblua5.3-0:amd64 : Shared library for the Lua interpreter version 5.3
liblwp-mediatypes-perl : module to guess media type for a file or a URL
liblwp-protocol-https-perl : HTTPS driver for LWP::UserAgent
liblz4-1:amd64 : Fast LZ compression algorithm library - runtime
liblz4-1:i386 : Fast LZ compression algorithm library - runtime
liblzma5:amd64 : XZ-format compression library
liblzma5:i386 : XZ-format compression library
liblzo2-2:amd64 : data compression library
libmagic-mgc : File type determination library using "magic" numbers (compiled magic file)
libmagic1:amd64 : Recognize the type of data in a file using "magic" numbers - library
libmagickcore-6.q16-6:amd64 : low-level image manipulation library -- quantum depth Q16
libmagickcore-6.q16-6-extra:amd64 : low-level image manipulation library - extra codecs (Q16)
libmagickwand-6.q16-6:amd64 : image manipulation library -- quantum depth Q16
libmailtools-perl : modules to manipulate email in perl programs
libmalcontent-0-0:amd64 : library for parental control of applications
libmalcontent-ui-1-1:amd64 : library for parental control of applications - GTK+ widgets and dialogs
libmanette-0.2-0:amd64 : Simple GObject game controller library
libmaxminddb0:amd64 : IP geolocation database library
libmbedcrypto7:amd64 : lightweight crypto and SSL/TLS library - crypto library
libmbim-glib4:amd64 : Support library to use the MBIM protocol
libmbim-proxy : Proxy to communicate with MBIM ports
libmbim-utils : Utilities to use the MBIM protocol from the command line
libmd0:amd64 : message digest functions from BSD systems - shared library
libmd0:i386 : message digest functions from BSD systems - shared library
libmediaart-2.0-0:amd64 : media art extraction and cache management library
libmfx1:amd64 : Intel Media SDK -- shared library
libmhash2:amd64 : Library for cryptographic hashing and message authentication
libminiupnpc17:amd64 : UPnP IGD client lightweight library
libmjpegutils-2.1-0:amd64 : MJPEG capture/editing/replay and MPEG encoding toolset (library)
libmm-glib0:amd64 : D-Bus service for managing modems - shared libraries
libmnl0:amd64 : minimalistic Netlink communication library
libmodplug1:amd64 : shared libraries for mod music based on ModPlug
libmount1:amd64 : device mounting library
libmount1:i386 : device mounting library
libmozjs-102-0:amd64 : SpiderMonkey JavaScript library
libmp3lame0:amd64 : MP3 encoding library
libmp3lame0:i386 : MP3 encoding library
libmpc3:amd64 : multiple precision complex floating-point library
libmpcdec6:amd64 : MusePack decoder - library
libmpeg2-4:amd64 : MPEG1 and MPEG2 video decoder library
libmpeg2encpp-2.1-0:amd64 : MJPEG capture/editing/replay and MPEG encoding toolset (library)
libmpfr6:amd64 : multiple precision floating-point computation
libmpg123-0:amd64 : MPEG layer 1/2/3 audio decoder (shared library)
libmpg123-0:i386 : MPEG layer 1/2/3 audio decoder (shared library)
libmplex2-2.1-0:amd64 : MJPEG capture/editing/replay and MPEG encoding toolset (library)
libmspack0:amd64 : library for Microsoft compression formats (shared library)
libmspub-0.1-1:amd64 : library for parsing the mspub file structure
libmtdev1:amd64 : Multitouch Protocol Translation Library - shared library
libmtp-common : Media Transfer Protocol (MTP) common files
libmtp-runtime : Media Transfer Protocol (MTP) runtime tools
libmtp9:amd64 : Media Transfer Protocol (MTP) library
libmutter-11-0:amd64 : window manager library from the Mutter window manager
libmwaw-0.3-3:amd64 : import library for some old Mac text documents
libmysofa1:amd64 : library to read HRTFs stored in the AES69-2015 SOFA format
libmythes-1.2-0:amd64 : simple thesaurus library
libnatpmp1:amd64 : portable and fully compliant implementation of NAT-PMP
libnautilus-extension4:amd64 : libraries for nautilus components - runtime version
libncurses6:amd64 : shared libraries for terminal handling
libncursesw6:amd64 : shared libraries for terminal handling (wide character support)
libndp0:amd64 : Library for Neighbor Discovery Protocol
libneon27:amd64 : HTTP and WebDAV client library
libnet-dbus-perl : Perl extension for the DBus bindings
libnet-http-perl : module providing low-level HTTP connection client
libnet-smtp-ssl-perl : Perl module providing SSL support to Net::SMTP
libnet-ssleay-perl:amd64 : Perl module for Secure Sockets Layer (SSL)
libnetfilter-conntrack3:amd64 : Netfilter netlink-conntrack library
libnettle8:amd64 : low level cryptographic library (symmetric and one-way cryptos)
libnettle8:i386 : low level cryptographic library (symmetric and one-way cryptos)
libnewt0.52:amd64 : Not Erik's Windowing Toolkit - text mode windowing with slang
libnfnetlink0:amd64 : Netfilter netlink library
libnfs13:amd64 : NFS client library (shared library)
libnftables1:amd64 : Netfilter nftables high level userspace API library
libnftnl11:amd64 : Netfilter nftables userspace API library
libnghttp2-14:amd64 : library implementing HTTP/2 protocol (shared library)
libnice10:amd64 : ICE library (shared library)
libnl-3-200:amd64 : library for dealing with netlink sockets
libnl-genl-3-200:amd64 : library for dealing with netlink sockets - generic netlink
libnl-route-3-200:amd64 : library for dealing with netlink sockets - route interface
libnm0:amd64 : GObject-based client library for NetworkManager
libnm0:i386 : GObject-based client library for NetworkManager
libnma-common : NetworkManager GUI library - translations
libnma-gtk4-0:amd64 : NetworkManager GUI GTK4 library
libnma0:amd64 : NetworkManager GUI library
libnorm1:amd64 : NACK-Oriented Reliable Multicast (NORM) library
libnotify4:amd64 : sends desktop notifications to a notification daemon
libnpth0:amd64 : replacement for GNU Pth using system threads
libnsl2:amd64 : Public client interface for NIS(YP) and NIS+
libnspr4:amd64 : NetScape Portable Runtime Library
libnss-mdns:amd64 : NSS module for Multicast DNS name resolution
libnss-myhostname:amd64 : nss module providing fallback resolution for the current hostname
libnss-systemd:amd64 : nss module providing dynamic user and group name resolution
libnss3:amd64 : Network Security Service libraries
libntfs-3g89:amd64 : read/write NTFS driver for FUSE (runtime library)
libnuma1:amd64 : Libraries for controlling NUMA policy
libnuma1:i386 : Libraries for controlling NUMA policy
libnumbertext-1.0-0:amd64 : Number to number name and money text conversion library
libnumbertext-data : Number to number name and money text conversion library -- data files
liboauth0:amd64 : C library implementing OAuth Core 1.0a API (runtime)
libodfgen-0.1-1:amd64 : library to generate ODF documents
libogg0:amd64 : Ogg bitstream library
libogg0:i386 : Ogg bitstream library
libonig5:amd64 : regular expressions library
libopenal-data : Software implementation of the OpenAL audio API (data files)
libopenal1:amd64 : Software implementation of the OpenAL audio API (shared library)
libopencore-amrnb0:amd64 : Adaptive Multi Rate speech codec - shared library
libopencore-amrwb0:amd64 : Adaptive Multi-Rate - Wideband speech codec - shared library
libopenexr-3-1-30:amd64 : runtime files for the OpenEXR image library
libopengl0:amd64 : Vendor neutral GL dispatch library -- OpenGL support
libopenh264-7:amd64 : OpenH264 Video Codec
libopenjp2-7:amd64 : JPEG 2000 image compression/decompression library
libopenjp2-7:i386 : JPEG 2000 image compression/decompression library
libopenmpt0:amd64 : module music library based on OpenMPT -- shared library
libopenni2-0:amd64 : framework for sensor-based 'Natural Interaction'
libopus0:amd64 : Opus codec runtime library
libopus0:i386 : Opus codec runtime library
liborc-0.4-0:amd64 : Library of Optimized Inner Loops Runtime Compiler
liborcus-0.17-0:amd64 : library for processing spreadsheet documents
liborcus-parser-0.17-0:amd64 : library for processing spreadsheet documents - parser library
libosinfo-1.0-0:amd64 : Library for managing information about operating systems and hypervisors
libosinfo-l10n : Translations for libosinfo
libostree-1-1:amd64 : content-addressed filesystem for operating system binaries (library)
libp11-kit0:amd64 : library for loading and coordinating access to PKCS#11 modules - runtime
libp11-kit0:i386 : library for loading and coordinating access to PKCS#11 modules - runtime
libpackagekit-glib2-18:amd64 : Library for accessing PackageKit using GLib
libpagemaker-0.0-0:amd64 : Library for importing and converting PageMaker Documents
libpam-gnome-keyring:amd64 : PAM module to unlock the GNOME keyring upon login
libpam-modules:amd64 : Pluggable Authentication Modules for PAM
libpam-modules-bin : Pluggable Authentication Modules for PAM - helper binaries
libpam-runtime : Runtime support for the PAM library
libpam-systemd:amd64 : system and service manager - PAM module
libpam0g:amd64 : Pluggable Authentication Modules library
libpango-1.0-0:amd64 : Layout and rendering of internationalized text
libpango-1.0-0:i386 : Layout and rendering of internationalized text
libpangocairo-1.0-0:amd64 : Layout and rendering of internationalized text
libpangocairo-1.0-0:i386 : Layout and rendering of internationalized text
libpangoft2-1.0-0:amd64 : Layout and rendering of internationalized text
libpangoft2-1.0-0:i386 : Layout and rendering of internationalized text
libpangomm-1.4-1v5:amd64 : C++ Wrapper for pango (shared libraries)
libpangoxft-1.0-0:amd64 : Layout and rendering of internationalized text
libpaper-utils : library for handling paper characteristics (utilities)
libpaper1:amd64 : library for handling paper characteristics
libparted-fs-resize0:amd64 : disk partition manipulator - shared FS resizing library
libparted2:amd64 : disk partition manipulator - shared library
libpcap0.8:amd64 : system interface for user-level packet capture
libpcaudio0:amd64 : C API to different audio devices - shared library
libpci3:amd64 : PCI utilities (shared library)
libpciaccess0:amd64 : Generic PCI access library for X
libpciaccess0:i386 : Generic PCI access library for X
libpcre2-8-0:amd64 : New Perl Compatible Regular Expression Library- 8 bit runtime files
libpcre2-8-0:i386 : New Perl Compatible Regular Expression Library- 8 bit runtime files
libpcsclite1:amd64 : Middleware to access a smart card using PC/SC (library)
libpeas-1.0-0:amd64 : Application plugin library
libpeas-common : Application plugin library (common files)
libperl4-corelibs-perl : libraries historically supplied with Perl 4
libperl5.36:amd64 : shared Perl library
libpgm-5.3-0:amd64 : OpenPGM shared library
libphonenumber8:amd64 : parsing/formatting/validating phone numbers
libpipeline1:amd64 : Unix process pipeline manipulation library
libpipewire-0.3-0:amd64 : libraries for the PipeWire multimedia server
libpipewire-0.3-common : libraries for the PipeWire multimedia server - common files
libpipewire-0.3-modules:amd64 : libraries for the PipeWire multimedia server - modules
libpixman-1-0:amd64 : pixel-manipulation library for X and cairo
libpixman-1-0:i386 : pixel-manipulation library for X and cairo
libplacebo208:amd64 : GPU-accelerated video/image rendering primitives (shared library)
libplist3:amd64 : Library for handling Apple binary and XML property lists
libplymouth5:amd64 : graphical boot animation and logger - shared libraries
libpng16-16:amd64 : PNG library - runtime (version 1.6)
libpng16-16:i386 : PNG library - runtime (version 1.6)
libpocketsphinx3:amd64 : Speech recognition tool - front-end library
libpolkit-agent-1-0:amd64 : polkit Authentication Agent API
libpolkit-gobject-1-0:amd64 : polkit Authorization API
libpoppler-cpp0v5:amd64 : PDF rendering library (CPP shared library)
libpoppler-glib8:amd64 : PDF rendering library (GLib-based shared library)
libpoppler126:amd64 : PDF rendering library
libpopt0:amd64 : lib for parsing cmdline parameters
libportal-gtk3-1:amd64 : Flatpak portal library for GTK 3 GUIs
libportal-gtk4-1:amd64 : Flatpak portal library for GTK 4 GUIs
libportal1:amd64 : Flatpak portal library - non-GUI part
libpostproc56:amd64 : FFmpeg library for post processing - runtime files
libproc2-0:amd64 : library for accessing process information from /proc
libprotobuf-c1:amd64 : Protocol Buffers C shared library (protobuf-c)
libprotobuf32:amd64 : protocol buffers C++ library
libproxy1-plugin-gsettings:amd64 : automatic proxy configuration management library (GSettings plugin)
libproxy1-plugin-networkmanager:amd64 : automatic proxy configuration management library (Network Manager plugin)
libproxy1-plugin-webkit:amd64 : automatic proxy configuration management library (Webkit plugin)
libproxy1v5:amd64 : automatic proxy configuration management library (shared)
libpsl5:amd64 : Library for Public Suffix List (shared libraries)
libpst4:amd64 : library for reading Microsoft Outlook PST files
libpulse-mainloop-glib0:amd64 : PulseAudio client libraries (glib support)
libpulse0:amd64 : PulseAudio client libraries
libpulse0:i386 : PulseAudio client libraries
libpwquality-common : library for password quality checking and generation (data files)
libpwquality1:amd64 : library for password quality checking and generation
libpython3-stdlib:amd64 : interactive high-level object-oriented language (default python3 version)
libpython3.11:amd64 : Shared Python runtime library (version 3.11)
libpython3.11-minimal:amd64 : Minimal subset of the Python language (version 3.11)
libpython3.11-stdlib:amd64 : Interactive high-level object-oriented language (standard library, version 3.11)
libqmi-glib5:amd64 : Support library to use the Qualcomm MSM Interface (QMI) protocol
libqmi-proxy : Proxy to communicate with QMI ports
libqmi-utils : Utilities to use the QMI protocol from the command line
libqpdf29:amd64 : runtime library for PDF transformation/inspection software
libqqwing2v5:amd64 : tool for generating and solving Sudoku puzzles (library)
libqrencode4:amd64 : QR Code encoding library
libqrtr-glib0:amd64 : Support library to use the QRTR protocol
libquadmath0:amd64 : GCC Quad-Precision Math Library
libqxp-0.0-0 : library for reading and converting QuarkXPress files
librabbitmq4:amd64 : AMQP client library written in C
libraptor2-0:amd64 : Raptor 2 RDF syntax library
librasqal3:amd64 : Rasqal RDF query library
librav1e0:amd64 : Fastest and safest AV1 encoder - shared library
librav1e0:i386 : Fastest and safest AV1 encoder - shared library
libraw1394-11:amd64 : library for direct access to IEEE 1394 bus (aka FireWire)
libraw20:amd64 : raw image decoder library
librdf0:amd64 : Redland Resource Description Framework (RDF) library
libreadline8:amd64 : GNU readline and history libraries, run-time libraries
libregexp-ipv6-perl : Regular expression for IPv6 addresses
libreoffice-base-core : office productivity suite -- shared library
libreoffice-calc : office productivity suite -- spreadsheet
libreoffice-common : office productivity suite -- arch-independent files
libreoffice-core : office productivity suite -- arch-dependent files
libreoffice-draw : office productivity suite -- drawing
libreoffice-gnome : office productivity suite -- GNOME integration
libreoffice-gtk3 : office productivity suite -- GTK+ 3 integration
libreoffice-help-common : office productivity suite -- common files for LibreOffice help
libreoffice-help-en-us : office productivity suite -- English_american help
libreoffice-impress : office productivity suite -- presentation
libreoffice-math : office productivity suite -- equation editor
libreoffice-style-colibre : office productivity suite -- colibre symbol style
libreoffice-style-elementary : office productivity suite -- Elementary symbol style
libreoffice-writer : office productivity suite -- word processor
librest-1.0-0:amd64 : REST service access library
librevenge-0.0-0:amd64 : Base Library for writing document interface filters
librhythmbox-core10:amd64 : support library for the rhythmbox music player
librist4:amd64 : Reliable Internet Stream Transport -- shared library
librsvg2-2:amd64 : SAX-based renderer library for SVG files (runtime)
librsvg2-2:i386 : SAX-based renderer library for SVG files (runtime)
librsvg2-common:amd64 : SAX-based renderer library for SVG files (extra runtime)
librsvg2-common:i386 : SAX-based renderer library for SVG files (extra runtime)
librtmp1:amd64 : toolkit for RTMP streams (shared library)
librubberband2:amd64 : audio time-stretching and pitch-shifting library
libruby:amd64 : Libraries necessary to run Ruby
libruby3.1:amd64 : Libraries necessary to run Ruby 3.1
librygel-core-2.8-0:amd64 : GNOME UPnP/DLNA services - core library
librygel-db-2.8-0:amd64 : GNOME UPnP/DLNA services - db library
librygel-renderer-2.8-0:amd64 : GNOME UPnP/DLNA services - renderer library
librygel-renderer-gst-2.8-0:amd64 : GNOME UPnP/DLNA services - renderer library
librygel-server-2.8-0:amd64 : GNOME UPnP/DLNA services - server library
libsamplerate0:amd64 : Audio sample rate conversion library
libsamplerate0:i386 : Audio sample rate conversion library
libsane-common : API library for scanners -- documentation and support files
libsane1:amd64 : API library for scanners
libsasl2-2:amd64 : Cyrus SASL - authentication abstraction library
libsasl2-modules:amd64 : Cyrus SASL - pluggable authentication modules
libsasl2-modules-db:amd64 : Cyrus SASL - pluggable authentication modules (DB)
libsbc1:amd64 : Sub Band CODEC library - runtime
libsdl2-2.0-0:amd64 : Simple DirectMedia Layer
libseccomp2:amd64 : high level interface to Linux seccomp filter
libsecret-1-0:amd64 : Secret store
libsecret-common : Secret store (common files)
libselinux1:amd64 : SELinux runtime shared libraries
libselinux1:i386 : SELinux runtime shared libraries
libsemanage-common : Common files for SELinux policy management libraries
libsemanage2:amd64 : SELinux policy management library
libsensors-config : lm-sensors configuration files
libsensors5:amd64 : library to read temperature/voltage/fan sensors
libsensors5:i386 : library to read temperature/voltage/fan sensors
libsepol2:amd64 : SELinux library for manipulating binary security policies
libserd-0-0:amd64 : lightweight RDF syntax library
libsgutils2-1.46-2:amd64 : utilities for devices using the SCSI command set (shared libraries)
libshine3:amd64 : Fixed-point MP3 encoding library - runtime files
libshine3:i386 : Fixed-point MP3 encoding library - runtime files
libshout3:amd64 : MP3/Ogg Vorbis broadcast streaming library
libshumate-1.0-1:amd64 : GTK4 widgets for embedded maps
libshumate-common : GTK4 widgets for embedded maps - common files
libsidplay1v5:amd64 : SID (MOS 6581) emulation library
libsigc++-2.0-0v5:amd64 : type-safe Signal Framework for C++ - runtime
libslang2:amd64 : S-Lang programming library - runtime version
libsm6:amd64 : X11 Session Management library
libsmartcols1:amd64 : smart column output alignment library
libsmbclient:amd64 : shared library for communication with SMB/CIFS servers
libsmbios-c2 : Provide access to (SM)BIOS information -- dynamic library
libsnapd-glib-2-1:amd64 : GLib snapd library
libsnappy1v5:amd64 : fast compression/decompression library
libsnappy1v5:i386 : fast compression/decompression library
libsndfile1:amd64 : Library for reading/writing audio files
libsndfile1:i386 : Library for reading/writing audio files
libsndio7.0:amd64 : Small audio and MIDI framework from OpenBSD, runtime libraries
libsnmp-base : SNMP configuration script, MIBs and documentation
libsnmp40:amd64 : SNMP (Simple Network Management Protocol) library
libsodium23:amd64 : Network communication, cryptography and signaturing library
libsonic0:amd64 : Simple library to speed up or slow down speech
libsord-0-0:amd64 : library for storing RDF data in memory
libsoundtouch1:amd64 : Sound stretching library
libsoup-3.0-0:amd64 : HTTP library implementation in C -- Shared library
libsoup-3.0-common : HTTP library implementation in C -- Common files
libsoup-gnome2.4-1:amd64 : HTTP library implementation in C -- GNOME support library
libsoup2.4-1:amd64 : HTTP library implementation in C -- Shared library
libsoup2.4-common : HTTP library implementation in C -- Common files
libsoxr0:amd64 : High quality 1D sample-rate conversion library
libsoxr0:i386 : High quality 1D sample-rate conversion library
libspa-0.2-bluetooth:amd64 : libraries for the PipeWire multimedia server - bluetooth plugins
libspa-0.2-modules:amd64 : libraries for the PipeWire multimedia server Simple Plugin API - modules
libspandsp2:amd64 : Telephony signal processing library
libspectre1:amd64 : Library for rendering PostScript documents
libspeechd2:amd64 : Speech Dispatcher: Shared libraries
libspeex1:amd64 : The Speex codec runtime library
libspeex1:i386 : The Speex codec runtime library
libspeexdsp1:amd64 : DSP library derived from speex
libspeexdsp1:i386 : DSP library derived from speex
libsphinxbase3:amd64 : Speech recognition tool - shared library
libsqlite3-0:amd64 : SQLite 3 shared library
libsratom-0-0:amd64 : library for serialising LV2 atoms to/from Turtle
libsrt1.5-gnutls:amd64 : Secure Reliable Transport UDP streaming library (GnuTLS flavour)
libsrtp2-1:amd64 : Secure RTP (SRTP) and UST Reference Implementations - shared library
libss2:amd64 : command-line interface parsing library
libssh-gcrypt-4:amd64 : tiny C SSH library (gcrypt flavor)
libssh2-1:amd64 : SSH2 client-side library
libssl3:amd64 : Secure Sockets Layer toolkit - shared libraries
libstaroffice-0.0-0:amd64 : Import filter library to import all StarOffice documents
libstartup-notification0:amd64 : library for program launch feedback (shared library)
libstdc++6:amd64 : GNU Standard C++ Library v3
libstdc++6:i386 : GNU Standard C++ Library v3
libstemmer0d:amd64 : Snowball stemming algorithms for use in Information Retrieval
libsuitesparseconfig5:amd64 : configuration routines for all SuiteSparse modules
libsvtav1enc1:amd64 : Scalable Video Technology for AV1 (libsvtav1enc shared library)
libsvtav1enc1:i386 : Scalable Video Technology for AV1 (libsvtav1enc shared library)
libswresample4:amd64 : FFmpeg library for audio resampling, rematrixing etc. - runtime files
libswresample4:i386 : FFmpeg library for audio resampling, rematrixing etc. - runtime files
libswscale6:amd64 : FFmpeg library for image scaling and various conversions - runtime files
libsynctex2:amd64 : TeX Live: SyncTeX parser library
libsystemd-shared:amd64 : systemd shared private library
libsystemd0:amd64 : systemd utility library
libsystemd0:i386 : systemd utility library
libtag1v5:amd64 : audio meta-data library
libtag1v5-vanilla:amd64 : audio meta-data library - vanilla flavour
libtalloc2:amd64 : hierarchical pool based memory allocator
libtasn1-6:amd64 : Manage ASN.1 structures (runtime)
libtasn1-6:i386 : Manage ASN.1 structures (runtime)
libtdb1:amd64 : Trivial Database - shared library
libteamdctl0:amd64 : library for communication with `teamd` process
libtevent0:amd64 : talloc-based event loop library - shared library
libtext-charwidth-perl:amd64 : get display widths of characters on the terminal
libtext-iconv-perl:amd64 : module to convert between character sets in Perl
libtext-wrapi18n-perl : internationalized substitute of Text::Wrap
libthai-data : Data files for Thai language support library
libthai0:amd64 : Thai language support library
libthai0:i386 : Thai language support library
libtheora0:amd64 : Theora Video Compression Codec
libtheora0:i386 : Theora Video Compression Codec
libtie-ixhash-perl : Perl module to order associative arrays
libtiff6:amd64 : Tag Image File Format (TIFF) library
libtiff6:i386 : Tag Image File Format (TIFF) library
libtimedate-perl : collection of modules to manipulate date/time information
libtinfo6:amd64 : shared low-level terminfo library for terminal handling
libtinfo6:i386 : shared low-level terminfo library for terminal handling
libtirpc-common : transport-independent RPC library - common files
libtirpc3:amd64 : transport-independent RPC library
libtotem-plparser-common : Totem Playlist Parser library - common files
libtotem-plparser18:amd64 : Totem Playlist Parser library - runtime files
libtotem0:amd64 : Main library for the Totem media player
libtracker-sparql-3.0-0:amd64 : metadata database, indexer and search tool - library
libtry-tiny-perl : module providing minimalistic try/catch
libtss2-esys-3.0.2-0:amd64 : TPM2 Software stack library - TSS and TCTI libraries
libtss2-mu0:amd64 : TPM2 Software stack library - TSS and TCTI libraries
libtss2-rc0:amd64 : TPM2 Software stack library - TSS and TCTI libraries
libtss2-sys1:amd64 : TPM2 Software stack library - TSS and TCTI libraries
libtss2-tcti-cmd0:amd64 : TPM2 Software stack library - TSS and TCTI libraries
libtss2-tcti-device0:amd64 : TPM2 Software stack library - TSS and TCTI libraries
libtss2-tcti-mssim0:amd64 : TPM2 Software stack library - TSS and TCTI libraries
libtss2-tcti-swtpm0:amd64 : TPM2 Software stack library - TSS and TCTI libraries
libtss2-tctildr0:amd64 : TPM2 Software stack library - TSS and TCTI libraries
libtwolame0:amd64 : MPEG Audio Layer 2 encoding library
libtwolame0:i386 : MPEG Audio Layer 2 encoding library
libuchardet0:amd64 : universal charset detection library - shared library
libudev1:amd64 : libudev shared library
libudev1:i386 : libudev shared library
libudfread0:amd64 : UDF reader library
libudisks2-0:amd64 : GObject based library to access udisks2
libunistring2:amd64 : Unicode string library for C
libunistring2:i386 : Unicode string library for C
libunity-protocol-private0:amd64 : binding to get places into the launcher - private library
libunity-scopes-json-def-desktop : binding to get places into the launcher - desktop def file
libunity9:amd64 : binding to get places into the launcher - shared library
libuno-cppu3 : LibreOffice UNO runtime environment -- CPPU public library
libuno-cppuhelpergcc3-3 : LibreOffice UNO runtime environment -- CPPU helper library
libuno-purpenvhelpergcc3-3 : LibreOffice UNO runtime environment -- "purpose environment" helper
libuno-sal3 : LibreOffice UNO runtime environment -- SAL public library
libuno-salhelpergcc3-3 : LibreOffice UNO runtime environment -- SAL helpers for C++ library
libunwind8:amd64 : library to determine the call-chain of a program - runtime
libupower-glib3:amd64 : abstraction for power management - shared library
liburi-perl : module to manipulate and access URI strings
libusb-1.0-0:amd64 : userspace USB programming library
libusbmuxd6:amd64 : USB multiplexor daemon for iPhone and iPod Touch devices - library
libuuid1:amd64 : Universally Unique ID library
libuv1:amd64 : asynchronous event notification library - runtime library
libv4l-0:amd64 : Collection of video4linux support libraries
libv4lconvert0:amd64 : Video4linux frame format conversion library
libva-drm2:amd64 : Video Acceleration (VA) API for Linux -- DRM runtime
libva-drm2:i386 : Video Acceleration (VA) API for Linux -- DRM runtime
libva-glx2:amd64 : Video Acceleration (VA) API for Linux -- GLX runtime
libva-glx2:i386 : Video Acceleration (VA) API for Linux -- GLX runtime
libva-x11-2:amd64 : Video Acceleration (VA) API for Linux -- X11 runtime
libva-x11-2:i386 : Video Acceleration (VA) API for Linux -- X11 runtime
libva2:amd64 : Video Acceleration (VA) API for Linux -- runtime
libva2:i386 : Video Acceleration (VA) API for Linux -- runtime
libvdpau-va-gl1:amd64 : VDPAU driver with OpenGL/VAAPI backend
libvdpau-va-gl1:i386 : VDPAU driver with OpenGL/VAAPI backend
libvdpau1:amd64 : Video Decode and Presentation API for Unix (libraries)
libvdpau1:i386 : Video Decode and Presentation API for Unix (libraries)
libvidstab1.1:amd64 : video stabilization library (shared library)
libvisio-0.1-1:amd64 : library for parsing the visio file structure
libvisual-0.4-0:amd64 : audio visualization framework
libvo-aacenc0:amd64 : VisualOn AAC encoder library
libvo-amrwbenc0:amd64 : VisualOn AMR-WB encoder library
libvolume-key1:amd64 : Library for manipulating storage encryption keys and passphrases
libvorbis0a:amd64 : decoder library for Vorbis General Audio Compression Codec
libvorbis0a:i386 : decoder library for Vorbis General Audio Compression Codec
libvorbisenc2:amd64 : encoder library for Vorbis General Audio Compression Codec
libvorbisenc2:i386 : encoder library for Vorbis General Audio Compression Codec
libvorbisfile3:amd64 : high-level API for Vorbis General Audio Compression Codec
libvpx7:amd64 : VP8 and VP9 video codec (shared library)
libvpx7:i386 : VP8 and VP9 video codec (shared library)
libvte-2.91-0:amd64 : Terminal emulator widget for GTK+ 3.0 - runtime files
libvte-2.91-common : Terminal emulator widget for GTK+ 3.0 - common files
libvulkan1:amd64 : Vulkan loader library
libvulkan1:i386 : Vulkan loader library
libwacom-common : Wacom model feature query library (common files)
libwacom9:amd64 : Wacom model feature query library
libwavpack1:amd64 : audio codec (lossy and lossless) - library
libwayland-client0:amd64 : wayland compositor infrastructure - client library
libwayland-client0:i386 : wayland compositor infrastructure - client library
libwayland-cursor0:amd64 : wayland compositor infrastructure - cursor library
libwayland-egl1:amd64 : wayland compositor infrastructure - EGL library
libwayland-server0:amd64 : wayland compositor infrastructure - server library
libwayland-server0:i386 : wayland compositor infrastructure - server library
libwbclient0:amd64 : Samba winbind client library
libwebkit2gtk-4.0-37:amd64 : Web content engine library for GTK
libwebkit2gtk-4.1-0:amd64 : Web content engine library for GTK
libwebkitgtk-6.0-4:amd64 : Web content engine library for GTK
libwebp7:amd64 : Lossy compression of digital photographic images
libwebp7:i386 : Lossy compression of digital photographic images
libwebpdemux2:amd64 : Lossy compression of digital photographic images.
libwebpmux3:amd64 : Lossy compression of digital photographic images
libwebpmux3:i386 : Lossy compression of digital photographic images
libwebrtc-audio-processing1:amd64 : AudioProcessing module from the WebRTC project.
libwildmidi2:amd64 : software MIDI player library
libwinpr2-2:amd64 : Windows Portable Runtime library
libwireplumber-0.4-0:amd64 : Shared libraries for WirePlumber
libwmflite-0.2-7:amd64 : Windows metafile conversion lite library
libwnck-3-0:amd64 : Window Navigator Construction Kit - runtime files
libwnck-3-common : Window Navigator Construction Kit - common files
libwoff1:amd64 : library for converting fonts to WOFF 2.0
libwpd-0.10-10:amd64 : Library for handling WordPerfect documents (shared library)
libwpg-0.3-3:amd64 : WordPerfect graphics import/convert library (shared library)
libwps-0.4-4:amd64 : Works text file format import filter library (shared library)
libwrap0:amd64 : Wietse Venema's TCP wrappers library
libwww-perl : simple and consistent interface to the world-wide web
libwww-robotrules-perl : database of robots.txt-derived permissions
libx11-6:amd64 : X11 client-side library
libx11-6:i386 : X11 client-side library
libx11-data : X11 client-side library
libx11-protocol-perl : Perl module for the X Window System Protocol, version 11
libx11-xcb1:amd64 : Xlib/XCB interface library
libx11-xcb1:i386 : Xlib/XCB interface library
libx264-164:amd64 : x264 video coding library
libx264-164:i386 : x264 video coding library
libx265-199:amd64 : H.265/HEVC video stream encoder (shared library)
libx265-199:i386 : H.265/HEVC video stream encoder (shared library)
libxapian30:amd64 : Search engine library
libxatracker2:amd64 : X acceleration library -- runtime
libxau6:amd64 : X11 authorisation library
libxau6:i386 : X11 authorisation library
libxaw7:amd64 : X11 Athena Widget library
libxcb-damage0:amd64 : X C Binding, damage extension
libxcb-dri2-0:amd64 : X C Binding, dri2 extension
libxcb-dri2-0:i386 : X C Binding, dri2 extension
libxcb-dri3-0:amd64 : X C Binding, dri3 extension
libxcb-dri3-0:i386 : X C Binding, dri3 extension
libxcb-glx0:amd64 : X C Binding, glx extension
libxcb-glx0:i386 : X C Binding, glx extension
libxcb-icccm4:amd64 : utility libraries for X C Binding -- icccm
libxcb-image0:amd64 : utility libraries for X C Binding -- image
libxcb-keysyms1:amd64 : utility libraries for X C Binding -- keysyms
libxcb-present0:amd64 : X C Binding, present extension
libxcb-present0:i386 : X C Binding, present extension
libxcb-randr0:amd64 : X C Binding, randr extension
libxcb-randr0:i386 : X C Binding, randr extension
libxcb-render-util0:amd64 : utility libraries for X C Binding -- render-util
libxcb-render0:amd64 : X C Binding, render extension
libxcb-render0:i386 : X C Binding, render extension
libxcb-res0:amd64 : X C Binding, res extension
libxcb-shape0:amd64 : X C Binding, shape extension
libxcb-shm0:amd64 : X C Binding, shm extension
libxcb-shm0:i386 : X C Binding, shm extension
libxcb-sync1:amd64 : X C Binding, sync extension
libxcb-sync1:i386 : X C Binding, sync extension
libxcb-util1:amd64 : utility libraries for X C Binding -- atom, aux and event
libxcb-xfixes0:amd64 : X C Binding, xfixes extension
libxcb-xfixes0:i386 : X C Binding, xfixes extension
libxcb-xkb1:amd64 : X C Binding, XKEYBOARD extension
libxcb-xv0:amd64 : X C Binding, xv extension
libxcb1:amd64 : X C Binding
libxcb1:i386 : X C Binding
libxcomposite1:amd64 : X11 Composite extension library
libxcursor1:amd64 : X cursor management library
libxcvt0:amd64 : VESA CVT standard timing modelines generator -- shared library
libxdamage1:amd64 : X11 damaged region extension library
libxdmcp6:amd64 : X11 Display Manager Control Protocol library
libxdmcp6:i386 : X11 Display Manager Control Protocol library
libxext6:amd64 : X11 miscellaneous extension library
libxext6:i386 : X11 miscellaneous extension library
libxfixes3:amd64 : X11 miscellaneous 'fixes' extension library
libxfixes3:i386 : X11 miscellaneous 'fixes' extension library
libxfont2:amd64 : X11 font rasterisation library
libxft2:amd64 : FreeType-based font drawing library for X
libxi6:amd64 : X11 Input extension library
libxinerama1:amd64 : X11 Xinerama extension library
libxinerama1:i386 : X11 Xinerama extension library
libxkbcommon-x11-0:amd64 : library to create keymaps with the XKB X11 protocol
libxkbcommon0:amd64 : library interface to the XKB compiler - shared library
libxkbfile1:amd64 : X11 keyboard file manipulation library
libxkbregistry0:amd64 : library to query available RMLVO
libxklavier16:amd64 : X Keyboard Extension high-level API
libxml-parser-perl : Perl module for parsing XML files
libxml-twig-perl : Perl module for processing huge XML documents in tree mode
libxml-xpathengine-perl : re-usable XPath engine for DOM-like trees
libxml2:amd64 : GNOME XML library
libxml2:i386 : GNOME XML library
libxmlb2:amd64 : Binary XML library
libxmlsec1:amd64 : XML security library
libxmlsec1-nss:amd64 : Nss engine for the XML security library
libxmlsec1-openssl:amd64 : Openssl engine for the XML security library
libxmu6:amd64 : X11 miscellaneous utility library
libxmuu1:amd64 : X11 miscellaneous micro-utility library
libxpm4:amd64 : X11 pixmap library
libxrandr2:amd64 : X11 RandR extension library
libxrender1:amd64 : X Rendering Extension client library
libxrender1:i386 : X Rendering Extension client library
libxres1:amd64 : X11 Resource extension library
libxshmfence1:amd64 : X shared memory fences - shared library
libxshmfence1:i386 : X shared memory fences - shared library
libxslt1.1:amd64 : XSLT 1.0 processing library - runtime library
libxss1:amd64 : X11 Screen Saver extension library
libxss1:i386 : X11 Screen Saver extension library
libxt6:amd64 : X11 toolkit intrinsics library
libxtables12:amd64 : netfilter xtables library
libxtst6:amd64 : X11 Testing -- Record extension library
libxv1:amd64 : X11 Video extension library
libxvidcore4:amd64 : Open source MPEG-4 video codec (library)
libxvidcore4:i386 : Open source MPEG-4 video codec (library)
libxvmc1:amd64 : X11 Video extension library
libxxf86dga1:amd64 : X11 Direct Graphics Access extension library
libxxf86vm1:amd64 : X11 XFree86 video mode extension library
libxxf86vm1:i386 : X11 XFree86 video mode extension library
libxxhash0:amd64 : shared library for xxhash
libyajl2:amd64 : Yet Another JSON Library
libyaml-0-2:amd64 : Fast YAML 1.1 parser and emitter library
libyelp0:amd64 : Library for the GNOME help browser
libytnef0:amd64 : improved decoder for application/ms-tnef attachments
libyuv0:amd64 : Library for YUV scaling (shared library)
libz3-4:amd64 : theorem prover from Microsoft Research - runtime libraries
libz3-4:i386 : theorem prover from Microsoft Research - runtime libraries
libzbar0:amd64 : QR code / bar code scanner and decoder (library)
libzimg2:amd64 : scaling, colorspace, depth conversion library (shared library)
libzmf-0.0-0:amd64 : Zoner Draw/Zebra file reading/converting library
libzmq5:amd64 : lightweight messaging kernel (shared library)
libzstd1:amd64 : fast lossless compression algorithm
libzstd1:i386 : fast lossless compression algorithm
libzvbi-common : Vertical Blanking Interval decoder (VBI) - common files
libzvbi0:amd64 : Vertical Blanking Interval decoder (VBI) - runtime files
libzvbi0:i386 : Vertical Blanking Interval decoder (VBI) - runtime files
libzxing2:amd64 : C++ port of ZXing library (library files)
lightsoff : Light puzzle game
linux-base : Linux image base package
linux-image-6.1.0-25-amd64 : Linux 6.1 for 64-bit PCs (signed)
linux-image-6.1.0-26-amd64 : Linux 6.1 for 64-bit PCs (signed)
linux-image-amd64 : Linux for 64-bit PCs (meta-package)
locales : GNU C Library: National Language (locale) data [support]
login : system login tools
logrotate : Log rotation utility
logsave : save the output of a command in a log file
lolcat : colorful `cat`
low-memory-monitor : Monitors low-memory conditions
lp-solve : Solve (mixed integer) linear programming problems
lsb-release : Linux Standard Base version reporting utility (minimal implementation)
lshw : information about hardware configuration
lsof : utility to list open files
lynx : classic non-graphical (text-mode) web browser
lynx-common : shared files for lynx package
mailcap : Debian's mailcap system, and support programs
malcontent : framework for parental control of applications
malcontent-gui : GUI to configure malcontent
man-db : tools for reading manual pages
manpages : Manual pages about using a GNU/Linux system
mawk : Pattern scanning and text processing language
media-player-info : Media player identification files
media-types : List of standard media types and their usual file extension
mesa-va-drivers:amd64 : Mesa VA-API video acceleration drivers
mesa-va-drivers:i386 : Mesa VA-API video acceleration drivers
mesa-vdpau-drivers:amd64 : Mesa VDPAU video acceleration drivers
mesa-vdpau-drivers:i386 : Mesa VDPAU video acceleration drivers
mesa-vulkan-drivers:amd64 : Mesa Vulkan graphics drivers
mesa-vulkan-drivers:i386 : Mesa Vulkan graphics drivers
mime-support : transitional package
minecraft-launcher : Official Minecraft Launcher
mobile-broadband-provider-info : database of mobile broadband service providers
modemmanager : D-Bus service for managing modems
mount : tools for mounting and manipulating filesystems
mutter-common : shared files for the Mutter window manager
mythes-en-us : English (USA) Thesaurus for LibreOffice
nano : small, friendly text editor inspired by Pico
nautilus : file manager and graphical shell for GNOME
nautilus-data : data files for nautilus
nautilus-extension-gnome-terminal:amd64 : GNOME terminal emulator application - Nautilus extension
ncurses-base : basic terminal type definitions
ncurses-bin : terminal-related programs and man pages
ncurses-term : additional terminal type definitions
netbase : Basic TCP/IP networking system
netcat-traditional : TCP/IP swiss army knife
network-manager : network management framework (daemon and userspace tools)
network-manager-gnome : network management framework (GNOME frontend)
nftables : Program to control packet filtering rules by Netfilter project
node-clipboard : Node.js module to copy to clipboard without flash
node-normalize.css : Modern alternative to CSS resets
node-prismjs : Lightweight, robust, elegant syntax highlighting
ntfs-3g : read/write NTFS driver for FUSE
ocl-icd-libopencl1:amd64 : Generic OpenCL ICD Loader
ocl-icd-libopencl1:i386 : Generic OpenCL ICD Loader
open-vm-tools : Open VMware Tools for virtual machines hosted on VMware (CLI)
open-vm-tools-desktop : Open VMware Tools for virtual machines hosted on VMware (GUI)
openjdk-17-jre:amd64 : OpenJDK Java runtime, using Hotspot JIT
openjdk-17-jre-headless:amd64 : OpenJDK Java runtime, using Hotspot JIT (headless)
openssh-client : secure shell (SSH) client, for secure access to remote machines
openssh-server : secure shell (SSH) server, for secure access from remote machines
openssh-sftp-server : secure shell (SSH) sftp server module, for SFTP access from remote machines
openssl : Secure Sockets Layer toolkit - cryptographic utility
orca : Scriptable screen reader
os-prober : utility to detect other OSes on a set of drives
osinfo-db : Operating system database files
p11-kit : p11-glue utilities
p11-kit-modules:amd64 : p11-glue proxy and trust modules
p7zip : 7zr file archiver with high compression ratio
p7zip-full : 7z and 7za file archivers with high compression ratio
packagekit : Provides a package management service
packagekit-tools : Provides PackageKit command-line tools
parted : disk partition manipulator
passwd : change and administer password and group data
patch : Apply a diff file to an original
pci.ids : PCI ID Repository
pciutils : PCI utilities
perl : Larry Wall's Practical Extraction and Report Language
perl-base : minimal Perl system
perl-modules-5.36 : Core Perl modules
perl-openssl-defaults:amd64 : version compatibility baseline for Perl OpenSSL packages
perl-tk : Perl module providing the Tk graphics library
pinentry-gnome3 : GNOME 3 PIN or pass-phrase entry dialog for GnuPG
pipewire:amd64 : audio and video processing engine multimedia server
pipewire-alsa:amd64 : PipeWire ALSA plugin
pipewire-audio : recommended set of PipeWire packages for a standard audio desktop use
pipewire-bin : PipeWire multimedia server - programs
pipewire-pulse : PipeWire PulseAudio daemon
pkexec : run commands as another user with polkit authorization
plymouth : boot animation, logger and I/O multiplexer
plymouth-label : boot animation, logger and I/O multiplexer - label control
pocketsphinx-en-us : Speech recognition tool - US English language model
polkitd : framework for managing administrative policies and privileges
poppler-data : encoding data for the poppler PDF rendering library
poppler-utils : PDF utilities (based on Poppler)
power-profiles-daemon : Makes power profiles handling available over D-Bus.
ppp : Point-to-Point Protocol (PPP) - daemon
procps : /proc file system utilities
psmisc : utilities that use the proc file system
publicsuffix : accurate, machine-readable list of domain name suffixes
python-apt-common : Python interface to libapt-pkg (locales)
python3 : interactive high-level object-oriented language (default python3 version)
python3-apt : Python 3 interface to libapt-pkg
python3-blinker : Fast, simple object-to-object and broadcast signaling (Python3)
python3-brlapi:amd64 : Braille display access via BRLTTY - Python3 bindings
python3-cairo:amd64 : Python3 bindings for the Cairo vector graphics library
python3-certifi : root certificates for validating SSL certs and verifying TLS hosts (python3)
python3-cffi-backend:amd64 : Foreign Function Interface for Python 3 calling C code - runtime
python3-chardet : Universal Character Encoding Detector (Python3)
python3-charset-normalizer : charset, encoding and language detection (Python 3)
python3-cryptography : Python library exposing cryptographic recipes and primitives (Python 3)
python3-cups:amd64 : Python3 bindings for CUPS
python3-cupshelpers : Python utility modules around the CUPS printing system
python3-dateutil : powerful extensions to the standard Python 3 datetime module
python3-dbus : simple interprocess messaging system (Python 3 interface)
python3-debconf : interact with debconf from Python 3
python3-debian : Python 3 modules to work with Debian-related data formats
python3-debianbts : Python interface to Debian's Bug Tracking System
python3-distro : Linux OS platform information API
python3-distro-info : information about distributions' releases (Python 3 module)
python3-gi : Python 3 bindings for gobject-introspection libraries
python3-gi-cairo : Python 3 Cairo bindings for the GObject library
python3-httplib2 : comprehensive HTTP client library written for Python3
python3-ibus-1.0 : Intelligent Input Bus - introspection overrides for Python (Python 3)
python3-idna : Python IDNA2008 (RFC 5891) handling (Python 3)
python3-jwt : Python 3 implementation of JSON Web Token
python3-lazr.restfulclient : client for lazr.restful-based web services (Python 3)
python3-lazr.uri : library for parsing, manipulating, and generating URIs
python3-louis : Python bindings for liblouis
python3-mako : fast and lightweight templating for the Python 3 platform
python3-markupsafe : HTML/XHTML/XML string library
python3-minimal : minimal subset of the Python language (default python3 version)
python3-oauthlib : generic, spec-compliant implementation of OAuth for Python3
python3-pkg-resources : Package Discovery and Resource Access using pkg_resources
python3-pyatspi : Assistive Technology Service Provider Interface - Python3 bindings
python3-pycurl : Python bindings to libcurl (Python 3)
python3-pyparsing : alternative to creating and executing simple grammars - Python 3.x
python3-pysimplesoap : simple and lightweight SOAP Library (Python 3)
python3-reportbug : Python modules for interacting with bug tracking systems
python3-requests : elegant and simple HTTP library for Python3, built for human beings
python3-six : Python 2 and 3 compatibility library
python3-smbc : Python 3 bindings for the Samba client library
python3-software-properties : manage the repositories that you install software from
python3-speechd : Python interface to Speech Dispatcher
python3-uno : Python-UNO bridge
python3-urllib3 : HTTP library with thread-safe connection pooling for Python3
python3-wadllib : Python 3 library for navigating WADL files
python3-xdg : Python 3 library to access freedesktop.org standards
python3.11 : Interactive high-level object-oriented language (version 3.11)
python3.11-minimal : Minimal subset of the Python language (version 3.11)
quadrapassel : popular Russian game, similar to Tetris
rake : ruby make-like utility
readline-common : GNU readline and history libraries, common files
realmd : DBus service for configuring kerberos and other online identities
reportbug : reports bugs in the Debian distribution
rhythmbox : music player and organizer for GNOME
rhythmbox-data : data files for rhythmbox
rhythmbox-plugin-cdrecorder : burning plugin for rhythmbox music player
rhythmbox-plugins : plugins for rhythmbox music player
rtkit : Realtime Policy and Watchdog Daemon
ruby : Interpreter of object-oriented scripting language Ruby (default version)
ruby-net-telnet : telnet client library
ruby-optimist : Commandline parser for Ruby that just gets out of your way
ruby-paint : terminal paint library with 256 color and effect support
ruby-rubygems : Package management framework for Ruby
ruby-sdbm:amd64 : simple file-based key-value store with String keys and values
ruby-webrick : HTTP server toolkit in Ruby
ruby-xmlrpc : XMLRPC library for Ruby
ruby3.1 : Interpreter of object-oriented scripting language Ruby
rubygems-integration : integration of Debian Ruby packages with Rubygems
runit-helper : dh-runit implementation detail
rygel : GNOME UPnP/DLNA services
rygel-playbin : GNOME UPnP/DLNA services - GStreamer Media Renderer plugin
rygel-tracker : GNOME UPnP/DLNA services - Tracker plugin
samba-libs:amd64 : Samba core libraries
sane-airscan : SANE backend for AirScan (eSCL) and WSD document scanner
sane-utils : API library for scanners -- utilities
seahorse : GNOME front end for GnuPG
sed : GNU stream editor for filtering/transforming text
sensible-utils : Utilities for sensible alternative selection
sgml-base : SGML infrastructure and SGML catalog file support
sgml-data : common SGML and XML data
shared-mime-info : FreeDesktop.org shared MIME database and spec
shotwell : digital photo organizer
shotwell-common : digital photo organizer - common files
simple-scan : Simple Scanning Utility
software-properties-common : manage the repositories that you install software from (common)
software-properties-gtk : manage the repositories that you install software from (GTK)
sound-icons : Sounds for speech enabled applications
sound-theme-freedesktop : freedesktop.org sound theme
speech-dispatcher : Common interface to speech synthesizers
speech-dispatcher-audio-plugins:amd64 : Speech Dispatcher: Audio output plugins
speech-dispatcher-espeak-ng : Speech Dispatcher: Espeak-ng output module
ssl-cert : simple debconf wrapper for OpenSSL
steam-launcher : Launcher for the Steam software distribution service
steam-libs:amd64 : Metapackage for Steam dependencies
steam-libs-amd64 : Steam libraries metapackage
steam-libs-i386:i386 : Steam libraries metapackage
sublime-text : Sublime Text is a sophisticated text editor for code, markup and prose
sudo : Provide limited super user privileges to specific users
swell-foop : Colored ball puzzle game
switcheroo-control : D-Bus service to check the availability of dual-GPU
synaptic : Graphical package manager
system-config-printer-common : backend and the translation files for system-config-printer
system-config-printer-udev : Utilities to detect and configure printers automatically
systemd : system and service manager
systemd-sysv : system and service manager - SysV compatibility symlinks
systemd-timesyncd : minimalistic service to synchronize local time with NTP servers
sysvinit-utils : System-V-like utilities
tali : sort of poker with dice and less money
tar : GNU version of the tar archiving utility
task-desktop : Debian desktop environment
task-english : General English environment
task-gnome-desktop : GNOME
task-ssh-server : SSH server
task-web-server : web server
tasksel : tool for selecting tasks for installation on Debian systems
tasksel-data : official tasks used for installation of Debian systems
timgm6mb-soundfont : TimGM6mb SoundFont from MuseScore 1.3
totem : Simple media player for the GNOME desktop based on GStreamer
totem-common : Data files for the Totem media player
totem-plugins : Plugins for the Totem media player
tpm-udev : udev rules for TPM modules
traceroute : Traces the route taken by packets over an IPv4/IPv6 network
tracker : metadata database, indexer and search tool
tracker-extract : metadata database, indexer and search tool - metadata extractors
tracker-miner-fs : metadata database, indexer and search tool - filesystem indexer
transmission-common : lightweight BitTorrent client (common files)
transmission-gtk : lightweight BitTorrent client (GTK+ interface)
tzdata : time zone and daylight-saving time data
ucf : Update Configuration File(s): preserve user changes to config files
udev : /dev/ and hotplug management daemon
udisks2 : D-Bus service to access and manipulate storage devices
uno-libs-private : LibreOffice UNO runtime environment -- private libraries used by public ones
unzip : De-archiver for .zip files
update-inetd : inetd configuration file updater
upower : abstraction for power management
ure : LibreOffice UNO runtime environment
usb-modeswitch : mode switching tool for controlling "flip flop" USB devices
usb-modeswitch-data : mode switching data for usb-modeswitch
usb.ids : USB ID Repository
usbmuxd : USB multiplexor daemon for iPhone and iPod Touch devices
usbutils : Linux USB utilities
usr-is-merged : Transitional package to assert a merged-/usr system
util-linux : miscellaneous system utilities
util-linux-extra : interactive login tools
util-linux-locales : locales files for util-linux
va-driver-all:amd64 : Video Acceleration (VA) API -- driver metapackage
va-driver-all:i386 : Video Acceleration (VA) API -- driver metapackage
vdpau-driver-all:amd64 : Video Decode and Presentation API for Unix (driver metapackage)
vdpau-driver-all:i386 : Video Decode and Presentation API for Unix (driver metapackage)
vim-common : Vi IMproved - Common files
vim-tiny : Vi IMproved - enhanced vi editor - compact version
wamerican : American English dictionary words for /usr/share/dict
webp-pixbuf-loader:amd64 : WebP Image format GdkPixbuf loader
wget : retrieves files from the web
whiptail : Displays user-friendly dialog boxes from shell scripts
wireless-regdb : wireless regulatory database for Linux
wireless-tools : Tools for manipulating Linux Wireless Extensions
wireplumber : modular session / policy manager for PipeWire
wpasupplicant : client support for WPA and WPA2 (IEEE 802.11i)
x11-apps : X applications
x11-common : X Window System (X.Org) infrastructure
x11-session-utils : X session utilities
x11-utils : X11 utilities
x11-xkb-utils : X11 XKB utilities
x11-xserver-utils : X server utilities
xauth : X authentication utility
xbitmaps : Base X bitmaps
xbrlapi : Access software for a blind person using a braille display - xbrlapi
xcvt : VESA CVT standard timing modelines generator
xdg-dbus-proxy : filtering D-Bus proxy
xdg-desktop-portal : desktop integration portal for Flatpak and Snap
xdg-desktop-portal-gnome : GNOME portal backend for xdg-desktop-portal
xdg-desktop-portal-gtk : GTK+/GNOME portal backend for xdg-desktop-portal
xdg-user-dirs : tool to manage well known user directories
xdg-user-dirs-gtk : tool to manage well known user directories (Gtk extension)
xdg-utils : desktop integration utilities from freedesktop.org
xfonts-100dpi : 100 dpi fonts for X
xfonts-75dpi : 75 dpi fonts for X
xfonts-base : standard fonts for X
xfonts-encodings : Encodings for X.Org fonts
xfonts-scalable : scalable fonts for X
xfonts-utils : X Window System font utility programs
xinit : X server initialisation tool
xkb-data : X Keyboard Extension (XKB) configuration data
xkbset : Small utility to change the AccessX settings of XKEYBOARD
xml-core : XML infrastructure and XML catalog file support
xorg : X.Org X Window System
xorg-docs-core : Core documentation for the X.org X Window System
xserver-common : common files used by various X servers
xserver-xephyr : nested X server
xserver-xorg : X.Org X server
xserver-xorg-core : Xorg X server - core server
xserver-xorg-input-all : X.Org X server -- input driver metapackage
xserver-xorg-input-libinput : X.Org X server -- libinput input driver
xserver-xorg-input-wacom : X.Org X server -- Wacom input driver
xserver-xorg-legacy : setuid root Xorg server wrapper
xserver-xorg-video-all : X.Org X server -- output driver metapackage
xserver-xorg-video-amdgpu : X.Org X server -- AMDGPU display driver
xserver-xorg-video-ati : X.Org X server -- AMD/ATI display driver wrapper
xserver-xorg-video-fbdev : X.Org X server -- fbdev display driver
xserver-xorg-video-intel : X.Org X server -- Intel i8xx, i9xx display driver
xserver-xorg-video-nouveau : X.Org X server -- Nouveau display driver
xserver-xorg-video-qxl : X.Org X server -- QXL display driver
xserver-xorg-video-radeon : X.Org X server -- AMD/ATI Radeon display driver
xserver-xorg-video-vesa : X.Org X server -- VESA display driver
xserver-xorg-video-vmware : X.Org X server -- VMware display driver
xwayland : X server for running X clients under Wayland
xz-utils : XZ-format compression utilities
yelp : Help browser for GNOME
yelp-xsl : XSL stylesheets for the yelp help browser
zenity : Display graphical dialog boxes from shell scripts
zenity-common : Display graphical dialog boxes from shell scripts (common files)
zerofree : zero free blocks from ext2, ext3 and ext4 file-systems
zip : Archiver for .zip files
zlib1g:amd64 : compression library - runtime
zlib1g:i386 : compression library - runtime
zstd : fast lossless compression algorithm -- CLI tool
